aðaleikarinn	aː ð a l ɛː j k a r ɪ n
aðaleinkenni	aː ð a l ɛ j ɲ cʰ ɛ n ɪ
aðaleyjarnar	aː ð a l ɛ j a t n a r
aðalgeirsdóttir	aː ð a l c ɛ j r̥ s t ɔ u h t ɪ r
aðalgeirsdóttir	aː ð a l c ɛ j r̥ s t ɔ u h t ɪ r
aðalgreinum	aː ð a l k r ɛ j n ʏ m
aðalheimild	aː ð a l h ɛ j m ɪ l t
aðallandstjórans	aː ð a l a n t s t j ɔ u r a n s
aðalleiðbeinanda	aː ð a l ɛ j ð p ɛ j n a n t a
aðalleiðbeinandi	aː ð a l ɛ j ð p ɛ j n a n t ɪ
aðalleit	aː ð a l ɛ j t
aðalpersónu	aː ð a l pʰ ɛ r̥ s ɔ u n ʏ
aðalskipulagi	aː ð a l s c ɪː p ʏ l aː j ɪ
aðalskipulaginu	aː ð a l s c ɪː p ʏ l aː j ɪ n ʏ
aðgengilegasta	a ð c ɛ j ɲ c ɪ l ɛ ɣ a s t a
aðgengilegir	a ð c ɛ j ɲ c ɪ l ɛ j ɪ r
aðgengilegum	a ð c ɛ j ɲ c ɪ l ɛ ɣ ʏ m
aðildarfyrirtækja	aː ð ɪ l t a r f ɪ r ɪ r tʰ aː j c a
aðrennslisgöng	a ð r ɛ n s t l ɪ s k œ j ŋ k
aðstoðarskólameistara	a ð s t ɔ ð a r s k ɔː u l a m ɛ j s t a r a
aðstoðarskólameistara	a ð s t ɔ ð a r s k ɔː u l a m ɛ j s t a r a
aðstoðarskólastjóra	a ð s t ɔ ð a r s k ɔː u l a s t j ɔː u r a
afbragðsfólk	a v p r a ɣ s f ɔ u l̥ k
afgreiðslukerfi	a v k r ɛ j ð s t l ʏ cʰ ɛ r v ɪ
afgreiðslunefnd	a v k r ɛ j ð s t l ʏ n ɛ m t
afkvæmarannsókn	a v kʰ v a j m a r a n s ɔ u h k n̥
afkvæmarannsókn	a v kʰ v a j m a r a n s ɔ u h k n̥
afkvæmin	a v kʰ v a j m ɪ n
afkvæminu	a v kʰ v a j m ɪ n ʏ
aflamarksbátum	a p l a m a r̥ k s p aː u t ʏ m
afleidd	a v l ɛ j t
afleiða	a v l ɛ j ð a
afleitar	a v l ɛ j t a r
afmælisbarnið	a m a j l ɪ s p a r t n ɪ ð
afmælisbarninu	a m a j l ɪ s p a r t n ɪ n ʏ
afmælisgesta	a m a j l ɪ s ɛ s t a
afmælispartí	a m a j l ɪ s p a r̥ t i
afmælissamkomu	a m a j l ɪ s a m kʰ ɔ m ʏ
afmælissönginn	a m a j l ɪ s œ j ɲ c ɪ n
afmælissönginn	a m a j l ɪ s œ j ɲ c ɪ n
afmælissöngnum	a m a j l ɪ s œ j ŋ k n ʏ m
afmælissöngnum	a m a j l ɪ s œ j ŋ k n ʏ m
afmælisveislan	a m a j l ɪ s v ɛ j s t l a n
afmælisveislan	a m a j l ɪ s v ɛ j s t l a n
afnotaleyfi	a v n ɔ t a l ɛː j v ɪ
afrekshópi	a v r ɛ x s h ɔː u p ɪ
afskiptalaus	a f s c ɪ f t a l œː j s
afstöðubreytingu	a f s t œ ð ʏ p r ɛː j t i ŋ k ʏ
afturhjólanna	a f t ʏ r ç ɔː u l a n a
aftursæta	a f t ʏ r s a j t a
afurðaaukning	aː v ʏ r ð a œ j h k n i ŋ k
agi	aː j ɪ
aginn	aː j ɪ n
akkilesarhæll	a h c ɪ l ɛ s a r h a j t l̥
akstursleiðin	a k s t ʏ r̥ s t l ɛ j ð ɪ n
akureyrarferð	aː k ʏ r ɛ j r a r f ɛ r ð
akureyrarhöfn	aː k ʏ r ɛ j r a r h œ p n̥
akureyrin	aː k ʏ r ɛː j r ɪ n
aldursdreifing	a l t ʏ r̥ s t r ɛ j v i ŋ k
aldursgreina	a l t ʏ r̥ s k r ɛ j n a
aldurstengds	a l t ʏ r̥ s t ɛ j ŋ t s
alfadeildinni	a l f a t ɛ j l t ɪ n ɪ
alfræðiorðabókin	a l f r a j ð ɪ ɔ r ð a p ɔː u c ɪ n
alfræðiorðabókin	a l f r a j ð ɪ ɔ r ð a p ɔː u c ɪ n
alfræðiriti	a l f r a j ð ɪ r ɪː t ɪ
algenga	a l c ɛ j ŋ k a
algengan	a l c ɛ j ŋ k a n
algengastar	a l c ɛ j ŋ k a s t a r
algengi	a l c ɛ j ɲ c ɪ
algengra	a l c ɛ j ŋ k r a
alheimi	aː l h ɛ j m ɪ
alheims	aː l h ɛ j m s
alkahóli	a l kʰ a h ɔː u l ɪ
alkóa	a l k ɔ u a
allflóknu	a t l̥ f l ɔ u h k n ʏ
allgóður	a t l̥ k ɔː u ð ʏ r
alllangt	a t l a ŋ̊ t
allstórir	a t l s t ɔː u r ɪ r
almannaheilla	a l m a n a h ɛ j t l a
almannatenglar	a l m a n a tʰ ɛ j ŋ l a r
almannatengsl	a l m a n a tʰ ɛ j ŋ s t l̥
almenningsbókasöfn	a l m ɛ n i ŋ s p ɔː u k a s œ p n̥
almenningseigu	a l m ɛ n i ŋ s ɛ j ɣ ʏ
almenningshlaupa	a l m ɛ n i ŋ s l̥ œː j p a
almenningssamgangna	a l m ɛ n i ŋ k s a m k a ŋ k n a
almenningssjóðunum	a l m ɛ n i ŋ s j ɔː u ð ɔ n ʏ m
alnæmisfaraldrinum	a l n a j m ɪ s f aː r a l t r ɪ n ʏ m
alræmdi	a l r a j m t ɪ
Alþjóðabankans	a l θ j ou ð a p a ŋ̊ k a n s
Alþjóðabankinn	a l θ j ou ð a p a ŋ̊ c ɪ n
amasónar	aː m a s ɔ u n a r
amfetamínneytendur	a m f ɛ t a m i n ɛː j t ɛ n t ʏ r
amtbókasafninu	a m̥ t p ɔ u k a s a p n ɪ n ʏ
andakílsbrautinni	a n t a cʰ i l s p r œː j t ɪ n ɪ
andey	a n t ɛ j
andleysið	a n t l ɛ j s ɪ ð
andnauð	a n t n œ j ð
andstæðir	a n t s t a j ð ɪ r
ang	a ŋ k
anga	a ŋ k a
angan	a ŋ k a n
angandi	a ŋ k a n t ɪ
anganin	a ŋ k a n ɪ n
angar	a ŋ k a r
angi	a ɲ c ɪ
angist	a ɲ c ɪ s t
angistar	a ɲ c ɪ s t a r
angistarfull	a ɲ c ɪ s t a r f ʏ t l̥
angra	a ŋ k r a
angraði	a ŋ k r a ð ɪ
angrar	a ŋ k r a r
angri	a ŋ k r ɪ
angur	a ŋ k ʏ r
angurværð	a ŋ k ʏ r v ai r ð
angurvært	a ŋ k ʏ r v ai r̥ t
angurværu	a ŋ k ʏ r v aiː r ʏ
ankeri	a h c ɛː r ɪ
ankeri	a ɲ̊ c ɛː r ɪ
apalhraun	aː p a l r̥ œ j n
apolló	a h p ɔ l ɔ u
appelsínugljáð	a h p ɛ l s i n ʏ k l j aː u ð
arðræninginn	a r ð r a j n i ɲ c ɪ n
arðsemisgreiningu	a r ð s ɛ m ɪ s k r ɛ j n i ŋ k ʏ
arfasáta	a r v a s aː u t a
arfasátuna	a r v a s aː u t ʏ n a
arfhreinleiki	a r v r̥ ɛ j n l ɛ j c ɪ
arisóna	aː r ɪ s ɔː u n a
Arnarnesvogi	a r t n a r n ɛ s v ɔː j ɪ
arnarvatnsheiðar	a r t n a r v a s h ɛ j ð a r
arnóri	a r t n ɔ u r ɪ
aronsdóttir	aː r ɔ n s t ɔ u h t ɪ r
asetóni	aː s ɛ t ɔ u n ɪ
atferlisgreining	aː t f ɛ r t l ɪ s k r ɛ j n i ŋ k
atgervisflótta	aː t c ɛ r v ɪ s f l ɔ u h t a
athugasemdalaust	aː tʰ ʏ ɣ a s ɛ m t a l œ j s t
athugið	aː t ʏ j ɪ ð
athygliprófi	aː tʰ ɪ k l ɪ p r ɔː u ɪ
Atlantshafsbandalagið	a h t l a n t s h a v s p a n t a l a j ɪ ð
Atlantshafsbandalaginu	a h t l a n t s h a v s p a n t a l a j ɪ n ʏ
atviksskráning	aː t v ɪ k s k r aː u n i ŋ k
atvinnuflugmannsskírteinis	aː t v ɪ n ʏ f l ʏ ɣ m a n s c i r̥ t ɛ j n ɪ s
atvinnuleitandi	aː t v ɪ n ʏ l ɛː j t a n t ɪ
atvinnuskráagerð	aː t v ɪ n ʏ s k r aː u a c ɛ r ð
au	œ j
auðlindanýtingar	œ j ð l ɪ n t a n iː t i ŋ k a r
auðnir	œ j ð n ɪ r
auðug	œː j ð ʏ ɣ
auðunarnaut	œː j ð ʏ n a r t n œ j t
auðunssonar	œː j ð ʏ n s ɔː n a r
auðveldum	œ j ð v ɛ l t ʏ m
auglýsingaferli	œ j ɣ l i s i ŋ k a f ɛ r t l ɪ
auglýsingastofuna	œ j ɣ l i s i ŋ k a s t ɔː v ʏ n a
auglýstri	œ j ɣ l i s t r ɪ
auglýstum	œ j ɣ l i s t ʏ m
augnbotna	œ j k n̥ p ɔ h t n a
augndeild	œ j n̥ t ɛ j l t
augndeild	œ j n̥ t ɛ j l t
augngríma	œ j k n̥ k r iː m a
augnhring	œ j k n̥ r̥ i ŋ k
augnkrem	œ j k n̥ kʰ r ɛː m
augnkremið	œ j k n̥ kʰ r ɛː m ɪ ð
augnpokar	œ j k n̥ pʰ ɔː k a r
augnskuggabox	œ j k n̥ s k ʏ k a p ɔ k s
augnsýkingu	œ j k n̥ s iː c i ŋ k ʏ
augntóttunum	œ j k n̥ t ɔ u h t ɔ n ʏ m
augntóttunum	œ j k n̥ t ɔ u h t ɔ n ʏ m
aukaaðalfundi	œː j k a a ð a l f ʏ n t ɪ
aukaaflið	œː j k a a p l ɪ ð
aukaafslátt	œː j k a a f s t l au h t
aukabita	œː j k a p ɪː t a
aukabúnað	œː j k a p uː n a ð
aukaefni	œː j k a ɛ p n ɪ
aukahlut	œː j k a l̥ ʏː t
aukahlutir	œː j k a l̥ ʏː t ɪ r
aukakraft	œː j k a kʰ r a f t
aukakrydd	œː j k a kʰ r ɪ t
aukamann	œː j k a m a n
aukaraf	œː j k a r a v
aukaskipana	œː j k a s c ɪː p a n a
aukasnertingu	œː j k a s t n ɛ r̥ t i ŋ k ʏ
aukatextum	œː j k a t ɛ k s t ʏ m
aukaverka	œː j k a v ɛ r̥ k a
aukaverkana	œː j k a v ɛ r̥ k a n a
aukaverkefna	œː j k a v ɛ r̥ k ɛ p n a
aukavinningar	œː j k a v ɪ n i ŋ k a r
aum	œː j m
aumkunarverða	œ j m̥ k ʏ n a r v ɛ r ð a
ausinn	œː j s ɪ n
austanlands	œ j s t a n l a n t s
austantjalds	œ j s t a n tʰ j a l t s
austantjaldslöndum	œ j s t a n tʰ j a l t s t l œ n t ʏ m
austmenn	œ j s t m ɛ n
austuramti	œ j s t ʏ r a m̥ t ɪ
austurbergs	œ j s t ʏ r p ɛ r k s
austurbæjar	œ j s t ʏ r p aː j a r
austurbæjar	œ j s t ʏ r p aː j a r
austurbænum	œ j s t ʏ r p aː j n ʏ m
austurbænum	œ j s t ʏ r p aː j n ʏ m
austurendann	œ j s t ʏ r ɛ n t a n
austurhlutanum	œ j s t ʏ r l̥ ʏː t a n ʏ m
austurhluti	œ j s t ʏ r l̥ ʏː t ɪ
austurhrauni	œ j s t ʏ r̥ œ j n ɪ
austurkot	œ j s t ʏ r kʰ ɔː t
austurriðils	œ j s t ʏ r ɪː ð ɪ l s
austurríski	œ j s t ʏ r i s c ɪ
austurrómverski	œ j s t ʏ r ɔ u m v ɛ r̥ s c ɪ
austurrómverski	œ j s t ʏ r ɔ u m v ɛ r̥ s c ɪ
áa	aː u a
áfallateymi	aː u f a t l a t ɛ j m ɪ
áfallateymi	aː u f a t l a t ɛ j m ɪ
áfengissjúklingar	aː u f ɛ j ɲ c ɪ s j u h k l i ŋ k a r
áfengissjúklingar	aː u f ɛ j ɲ c ɪ s j u h k l i ŋ k a r
áformuð	aː u f ɔ r m ʏ ð
áframsendingu	aː u f r a m s ɛ n t i ŋ k ʏ
áframsendist	aː u f r a m s ɛ n t ɪ s t
áfrýjandi	aː u f r i j a n t ɪ
áfrýjanir	aː u f r i j a n ɪ r
áfrýjun	aː u f r i j ʏ n
áfrýjunardómstóll	aː u f r i j ʏ n a r t ɔ u m s t ɔ u t l̥
áfrýjunardómstóll	aː u f r i j ʏ n a r t ɔ u m s t ɔ u t l̥
áfrýjunarefnd	aː u f r i j ʏ n a r n ɛ m t
ágreiningurinn	aː u k r ɛ j n i ŋ k ʏ r ɪ n
ágreiningurinn	aː u k r ɛ j n i ŋ k ʏ r ɪ n
áhafnarskipta	aː u h a p n a r s c ɪ f t a
áhersluauka	aː u h ɛ r̥ s t l ʏ œː j k a
áhersluauka	aː u h ɛ r̥ s t l ʏ œː j k a
áherslubreytingar	aː u h ɛ r̥ s t l ʏ p r ɛː j t i ŋ k a r
áherslubreytingar	aː u h ɛ r̥ s t l ʏ p r ɛː j t i ŋ k a r
áheyrandi	aː u h ɛ j r a n t ɪ
áheyrandi	aː u h ɛ j r a n t ɪ
áheyrnarfulltrúar	aː u h ɛ j r t n a r f ʏ t l̥ tʰ r u a r
áheyrnarfulltrúar	aː u h ɛ j r t n a r f ʏ t l̥ tʰ r u a r
áhorfandi	aː u h ɔ r v a n t ɪ
áhrifamaður	aː u r̥ ɪ v a m aː ð ʏ r
áhrifasagan	aː u r̥ ɪ v a s aː ɣ a n
áhugamanneskja	aː u h ʏ ɣ a m a n ɛ s c a
áhugamanni	aː u h ʏ ɣ a m a n ɪ
áhugasamt	aː u h ʏ ɣ a s a m̥ t
áhugaverðri	aː u h ʏ ɣ a v ɛ r ð r ɪ
áhugi	auː h ʏ j ɪ
áhuginn	auː h ʏ j ɪ n
áir	aː u ɪ r
ákavíti	aː u kʰ a v iː t ɪ
ákvarðanirnar	aː u kʰ v a r ð a n ɪ t n a r
ákvörðunarlandinu	aː u kʰ v œ r ð ʏ n a r l a n t ɪ n ʏ
álagi	auː l a j ɪ
álagið	auː l a j ɪ ð
álagningarstofn	aː u l a k n i ŋ k a r s t ɔ p n̥
álfyrirtækisins	aː u l f ɪ r ɪ r tʰ aː j c ɪ s ɪ n s
álfyrirtækisins	aː u l f ɪ r ɪ r tʰ aː j c ɪ s ɪ n s
álfþórsson	au l v θ ɔ u r̥ s ɔː n
álitaefnum	aː u l ɪ t a ɛ p n ʏ m
álitlegum	aː u l ɪ t l ɛː ɣ ʏ m
álitsbeiðni	aː u l ɪ t s p ɛ j ð n ɪ
álitsbeiðni	aː u l ɪ t s p ɛ j ð n ɪ
álplata	aː u l pʰ l a t a
álversandstæðingum	au l v ɛ r̥ s a n t s t a j ð i ŋ k ʏ m
ályktunina	aː u l ɪ x t ʏ n ɪ n a
árangursstjórnun	aː u r au ŋ k ʏ r̥ s t j ɔ u r t n ʏ n
áratugi	auː r a t ʏː j ɪ
áratugina	auː r a t ʏː j ɪ n a
áratuginn	auː r a t ʏː j ɪ n
áratugir	auː r a t ʏː j ɪ r
áratugs	aː u r a tʰ ʏ k s
áreiðanlega	auː r ai ð a n l ɛ ɣ a
árekstraprófanir	aː u r ɛ k s t r a pʰ r ɔː u a n ɪ r
árekstraprófanir	aː u r ɛ k s t r a pʰ r ɔː u a n ɪ r
áreyrum	aː u r ɛ j r ʏ m
áreyrum	aː u r ɛ j r ʏ m
árgangsmótið	au r k au ŋ s m ɔː u t ɪ ð
ármótahyl	au r m ɔ u t a h ɪː l
ármótunum	au r m ɔ u t ɔ n ʏ m
árskaup	au r̥ s kʰ œː j p
ársreikningar	au r̥ s r ɛ j h k n i ŋ k a r
ársreikningsins	au r̥ s r ɛ j h k n i ŋ s ɪ n s
ásar	aː u s a r
ásatrú	aː u s a tʰ r uː
ásatrúar	aː u s a tʰ r uː a r
ásigkomulagi	auː s ɪ ɣ k ɔ m ʏ l aː j ɪ
áskelsdóttir	aː u s cʰ ɛ l s t ɔ u h t ɪ r
áskelsdóttir	aː u s cʰ ɛ l s t ɔ u h t ɪ r
áskorendur	aː u s k ɔ r ɛ n t ʏ r
áskriftar	aː u s k r ɪ f t a r
áskriftarkortunum	aː u s k r ɪ f t a r̥ kʰ ɔ r̥ t ɔ n ʏ m
áskriftartölur	aː u s k r ɪ f t a r̥ tʰ œː l ʏ r
ásrúnar	aː u s r u n a r
ástandsbreyting	aː u s t a n t s p r ɛː j t i ŋ k
ástandsbreyting	aː u s t a n t s p r ɛː j t i ŋ k
ástarleiki	au s t a r l ɛː j c ɪ
ástgeirsdóttur	au s t c ɛ j r̥ s t ɔ u h t ʏ r
ástgeirsdóttur	au s t c ɛ j r̥ s t ɔ u h t ʏ r
ástríðuleikur	aː u s t r i ð ʏ l ɛː j k ʏ r
ástríðuleikur	aː u s t r i ð ʏ l ɛː j k ʏ r
ástundunin	aː u s t ʏ n t ʏ n ɪ n
ásubergsskipið	aː u s ʏ p ɛ r k s c ɪː p ɪ ð
átaksverkefna	aː u tʰ a k s v ɛ r̥ k ɛ p n a
átfrumum	aː u t f r ʏ m ʏ m
ávaxtaflugunnar	aː u v a k s t a f l ʏː ɣ ʏ n a r
ávaxtamauki	aː u v a k s t a m œː j c ɪ
ávaxtamauki	aː u v a k s t a m œː j c ɪ
áverkarnir	aː u v ɛ r̥ k a t n ɪ r
badmintonráð	p a t m ɪ n tʰ ɔ n r aː u ð
baháí	p aː h a j i
bakkabraut	p a h k a p r œː j t
bakkaskjóls	p a h k a s c ɔ u l s
bakmeiðsl	p aː k m ɛː j ð s t l̥
baldursbrár	p a l t ʏ r̥ s p r aː u r
bananamauk	p aː n a n a m œː j k
banasótt	p aː n a s ɔ u h t
bandalagi	p a n t a l aː j ɪ
bandalagið	p a n t a l aː j ɪ ð
bandalaginu	p a n t a l aː j ɪ n ʏ
banginn	p a ɲ c ɪ n
Bangkok	p a ŋ k ɔ h k
Bangladesh	p a ŋ l a t ɛ s
bangsa	p a ŋ s a
bangsanum	p a ŋ s a n ʏ m
bangsar	p a ŋ s a r
bangsi	p a ŋ s ɪ
bangsinn	p a ŋ s ɪ n
Bangsímon	p a ŋ s i m ɔ n
bank	p a ŋ̊ k
banka	p a ŋ̊ k a
bankabók	p a ŋ̊ k a p ouː k
bankað	p a ŋ̊ k a ð
bankaði	p a ŋ̊ k a ð ɪ
bankakerfið	p a ŋ̊ k a c ɛ r v ɪ ð
bankakerfinu	p a ŋ̊ k a c ɛ r v ɪ n ʏ
bankamanna	p a ŋ̊ k a m a n a
bankana	p a ŋ̊ k a n a
bankann	p a ŋ̊ k a n
bankanna	p a ŋ̊ k a n a
bankans	p a ŋ̊ k a n s
bankanum	p a ŋ̊ k a n ʏ m
bankar	p a ŋ̊ k a r
bankareikning	p a ŋ̊ k a r ei h k n i ŋ k
bankarnir	p a ŋ̊ k a t n ɪ r
bankastjóra	p a ŋ̊ k a s t j ouː r a
bankastjórar	p a ŋ̊ k a s t j ouː r a r
bankastjóri	p a ŋ̊ k a s t j ouː r ɪ
bankastjórnin	p au ŋ̊ k a s t j ɔ u r t n ɪ n
Bankastræti	p a ŋ̊ k a s t r aiː t ɪ
bankaþjónusta	p a ŋ̊ k a θ j ouː n ʏ s t a
bankaþjónustu	p a ŋ̊ k a θ j ouː n ʏ s t ʏ
banki	p a ɲ̊ c ɪ
bankinn	p a ɲ̊ c ɪ n
banks	p a ŋ̊ s
bardagi	p a r t a j ɪ
bardaginn	p a r t a j ɪ n
barnabílstólar	p a r t n a p i l s t ɔ u l a r
barnabókasöfn	p a r t n a p ɔː u k a s œ p n̥
barnabókavörðurinn	p a r t n a p ɔː u k a v œ r ð ʏ r ɪ n
barnafólki	p a r t n a f ɔ u l̥ c ɪ
barnahreyfing	p a r t n a r̥ ɛː j v i ŋ k
barnalækna	p a r t n a l a j h k n a
barnalæknis	p a r t n a l a j h k n ɪ s
barnanauðgara	p a r t n a n œ j ð k a r a
barnastóll	p a r t n a s t ɔ u t l̥
barnatannlækningum	p a r t n a tʰ a n l a j h k n i ŋ k ʏ m
barnauppeldi	p a t n a ʏ h p ɛ l t ɪ
barndómi	p a r t n t ɔː u m ɪ
barselóna	p a r̥ s ɛ l ɔː u n a
baugfingur	p œ j ɣ f i ŋ k ʏ r
baugsfeðgar	p œ j x s f ɛ ð k a r
baugskafli	p œ j x s k a p l ɪ
baugsmenn	p œ j x s m ɛ n
baunabelgi	p œː j n a p ɛ l c ɪ
baunirnar	p œː j n ɪ t n a r
beiðist	p ɛː j ð ɪ s t
beiðnin	p ɛ j ð n ɪ n
beinakaflann	p ɛː j n a kʰ a p l a n
beinfrumur	p ɛ j n f r ʏ m ʏ r
beinlausar	p ɛ j n l œ j s a r
beinlausar	p ɛ j n l œ j s a r
beinmerg	p ɛ j n m ɛ r k
beinmergs	p ɛ j n m ɛ r k s
beinmótandi	p ɛ j n m ɔ u t a n t ɪ
beinmótandi	p ɛ j n m ɔ u t a n t ɪ
beinmyndandi	p ɛ j n m ɪ n t a n t ɪ
beinskipt	p ɛ j n s c ɪ f t
beinskiptan	p ɛ j n s c ɪ f t a n
beinskipting	p ɛ j n s c ɪ f t i ŋ k
beinteinn	p ɛ j n tʰ ɛ j t n̥
beinteins	p ɛ j n tʰ ɛ j n s
beinvernd	p ɛ j n v ɛ n t
beinverndardag	p ɛ j n v ɛ r n t a r t aː ɣ
beinverndarsamtakanna	p ɛ j n v ɛ r n t a r s a m tʰ a k a n a
beinvöxt	p ɛ j n v œ k s t
beitiland	p ɛː j t ɪ l a n t
beitinni	p ɛː j t ɪ n ɪ
bensíntanki	p ɛ n s i n t a ɲ̊ c ɪ
bergstein	p ɛ r k s t ɛ j n
bergsteinsdóttur	p ɛ r k s t ɛ j n s t ɔ u h t ʏ r
bergsteinsdóttur	p ɛ r k s t ɛ j n s t ɔ u h t ʏ r
bessastaðaá	p ɛ s a s t a ð a aː u
beyging	p ɛ j i ŋ k
beygist	p ɛ j ɪ s t
beygjuakrein	p ɛ j ʏ aː k r ɛ j n
beygjubúnaðurinn	p ɛ j ʏ p uː n a ð ʏ r ɪ n
beyglu	p ɛ j k l ʏ
beykiinnrétting	p ɛː j c ɪ ɪ n r j ɛ h t i ŋ k
bifhjólum	p ɪ f ç ɔː u l ʏ m
bifhærðar	p ɪː v h a j r ð a r
bifreiðabóta	p ɪ v r ɛ j ð a p ɔː u t a
bifreiðabóta	p ɪ v r ɛ j ð a p ɔː u t a
bifreiðakerfi	p ɪ v r ɛ j ð a cʰ ɛ r v ɪ
bifreiðastyrkjum	p ɪ v r ɛ j ð a s t ɪ r̥ c ʏ m
bikarleiknum	p ɪː k a r t l ɛ j h k n ʏ m
bindindisfræðslu	p ɪ n t ɪ n t ɪ s f r a j ð s t l ʏ
birkifræja	p ɪ r̥ c ɪ f r a j a
bitlausan	p ɪː t l œ j s a n
biturleiki	p ɪː t ʏ r l ɛ j c ɪ
bílaumferð	p iː l a ʏ m f ɛ r ð
bíslagið	p iː s t l a j ɪ ð
bjarnhéðinsdóttir	p j a t n ç ɛː ð ɪ n s t ɔ u h t ɪ r
bjánalegur	p j aː u n a l ɛ ɣ ʏ r
bjórbandið	p j ɔ u r p a n t ɪ ð
bjórkippu	p j ɔ u r̥ c ɪ h p ʏ
bjórstofa	p j ɔ u r̥ s t ɔː v a
björgunarskóli	p j œ r k ʏ n a r s k ɔː u l ɪ
björgunarsveit	p j œ r k ʏ n a r s v ɛː j t
björgunarsveitar	p j œ r k ʏ n a r s v ɛ j t a r
björgunarsveitarinnar	p j œ r k ʏ n a r s v ɛ j t a r ɪ n a r
björgunarsveitina	p j œ r k ʏ n a r s v ɛ j t ɪ n a
björgunarsveitinni	p j œ r k ʏ n a r s v ɛ j t ɪ n ɪ
blaðaljósmyndun	p l aː ð a l j ɔː u s m ʏ n t ʏ n
blank	p l a ŋ̊ k
blankur	p l a ŋ̊ k ʏ r
blautsvampur	p l œ j t s v a m̥ p ʏ r
bláeyg	p l aː u ɛː j ɣ
bláeyg	p l aː u ɛː j ɣ
blásarakvintett	p l aː u s a r a kʰ v ɪ n t ɛ h t
blásaranna	p l aː u s a r a n a
blásin	p l aː u s ɪ n
bláskinssvell	p l aː u s c ɪ n s v ɛ t l̥
bláskjór	p l aː u s c ɔː u r
bláskjór	p l aː u s c ɔː u r
bleiki	p l ɛː j c ɪ
bleikja	p l ɛː j c a
bleiulaus	p l ɛː j ʏ l œː j s
bleiulaus	p l ɛː j ʏ l œː j s
bleiuvigt	p l ɛ j ʏ v ɪ x t
bleksprautu	p l ɛː k s p r œː j t ʏ
bleksprautuprentara	p l ɛː k s p r œː j t ʏ pʰ r ɛ n̥ t a r a
bleyju	p l ɛ j ʏ
bleyjuna	p l ɛ j ʏ n a
Blóðbankinn	p l ou ð p a ŋ̊ c ɪ n
blóðfitur	p l ɔ u ð f ɪ t ʏ r
blóðflokkamótefni	p l ɔ u ð f l ɔ h k a m ɔː u t ɛ p n ɪ
blóðflögur	p l ɔ u ð f l œ ɣ ʏ r
blóðhlaupnum	p l ɔ u ð l̥ œ j h p n ʏ m
blóðhlaupnum	p l ɔ u ð l̥ œ j h p n ʏ m
blóðhlutalager	p l ɔ u ð l̥ ʏ tʰ a l aː ɣ ɛ r
blóðprufunni	p l ɔ u ð pʰ r ʏ v ʏ n ɪ
blóðskilun	p l ɔ u ð s c ɪ l ʏ n
blóðtappar	p l ɔ u ð t a h p a r
blómabúð	p l ɔː u m a p uː ð
blómavasar	p l ɔː u m a v aː s a r
blómhnappurinn	p l ɔː u m n̥ a h p ʏ r ɪ n
blóminu	p l ɔː u m ɪ n ʏ
blómleggi	p l ɔ u m l ɛ c ɪ
blómskipan	p l ɔ u m s c ɪ p a n
blómskrúð	p l ɔ u m s k r uː ð
blóraböggulinn	p l ɔː u r a p œ k ʏ l ɪ n
blýeitrun	p l iː ɛː j t r ʏ n
blýrafgeymir	p l iː r a v k ɛ j m ɪ r
blæstri	p l a j s t r ɪ
blönk	p l œ n̥ k
bogi	p ɔː j ɪ
bogin	p ɔː j ɪ n
boginn	p ɔː j ɪ n
borgarabandalagið	p ɔ r k a r a p a n t a l a j ɪ ð
borgarhjólunum	p ɔ r k a r ç ɔː u l ɔ n ʏ m
borgarljósin	p ɔ r k a r l j ɔː u s ɪ n
borgarstjórnarfundur	p ɔ r k a r s t j ɔ u r t n a r f ʏ n t ʏ r
borgarstæðinu	p ɔ r k a r s t aː j ð ɪ n ʏ
bornhólm	p ɔ r n h ɔ u l m
botngróður	p ɔ h t n̥ k r ɔ u ð ʏ r
boxleik	p ɔ k s l ɛ j k
Bragi	p r aː j ɪ
bragleysa	p r a ɣ l ɛ j s a
brauðinu	p r œ j ð ɪ n ʏ
brauðraspi	p r œ j ð r a s p ɪ
brauðtertum	p r œ j ð t ɛ r̥ t ʏ m
brautarkeppni	p r œː j t a r cʰ ɛ h p n ɪ
brautarlýsing	p r œː j t a r l iː s i ŋ k
brautarmerki	p r œː j t a r m ɛ r̥ c ɪ
breiddir	p r ɛ j t ɪ r
breiðuvíkurhrepps	p r ɛː j ð ʏ v iː k ʏ r̥ ɛ h p s
brenglaðar	p r ɛ j ŋ l a ð a r
brennisteinn	p r ɛ n ɪ s t ɛ j t n̥
brennisteinsgulan	p r ɛ n ɪ s t ɛ j n s k ʏː l a n
breyskur	p r ɛ j s k ʏ r
breytilegasta	p r ɛː j t ɪ l ɛ ɣ a s t a
breytilegra	p r ɛː j t ɪ l ɛ ɣ r a
breytingagjald	p r ɛː j t i ŋ k a c a l t
breytingartillögunum	p r ɛː j t i ŋ k a r tʰ ɪ l œ ɣ ɔ n ʏ m
breytu	p r ɛː j t ʏ
breytur	p r ɛː j t ʏ r
bringuhár	p r i ŋ k ʏ h aː u r
brjóstabarn	p r j ɔ u s t a p a r t n̥
brjóstagjöfum	p r j ɔ u s t a c œː v ʏ m
brjóstaminnkun	p r j ɔ u s t a m i ŋ̊ k ʏ n
brjóstamjólkinni	p r j ɔ u s t aː m j ɔ u l̥ c ɪ n ɪ
broddadóttur	p r ɔ t a t ɔ u h t ʏ r
bróðurarf	p r ɔː u ð ʏ r a r v
bróðurpart	p r ɔː u ð ʏ r pʰ a r t
bróðurparti	p r ɔː u ð ʏ r pʰ a r̥ t ɪ
brunahænsni	p r ʏː n a h a j n s t n ɪ
brunnbáturinn	p r ʏ n p aː u t ʏ r ɪ n
brúðkaupsdaginn	p r u ð k œy p s t aː j ɪ n
brúnleita	p r u n l ɛ j t a
brúsahlaup	p r uː s a l̥ œː j p
brynjarsdóttur	p r ɪ n j a r̥ s t ɔ u h t ʏ r
bræðivör	p r aː j ð ɪ v œ r
bræðsla	p r a j ð s t l a
brælu	p r aː j l ʏ
bumbuheimum	p ʏ m p ʏ h ɛː j m ʏ m
Búnaðarbanka	p uː n a ð a r p a ŋ̊ k a
Búnaðarbankann	p uː n a ð a r p a ŋ̊ k a n
Búnaðarbankans	p uː n a ð a r p a ŋ̊ k a n s
Búnaðarbankanum	p uː n a ð a r p a ŋ̊ k a n ʏ m
Búnaðarbanki	p uː n a ð a r p a ɲ̊ c ɪ
Búnaðarbankinn	p uː n a ð a r p a ɲ̊ c ɪ n
byggðarlagi	p ɪ ɣ ð a r l aː j ɪ
byggðarlagið	p ɪ ɣ ð a r l aː j ɪ ð
byggðarlaginu	p ɪ ɣ ð a r l aː j ɪ n ʏ
byggingadeild	p ɪ c i ŋ k a t ɛ j l t
byggingarreit	p ɪ c i ŋ k a r ɛː j t
byggingarreitir	p ɪ c i ŋ k a r ɛ j t ɪ r
byggingastjóra	p ɪ c i ŋ k a s t j ɔː u r a
byrjunareinkenni	p ɪ r j ʏ n a r ɛ j n cʰ ɛ n ɪ
byrjunarörðugleika	p ɪ r j ʏ n a r œ r ð ʏ ɣ l ɛː j k a
bönkuðu	p œ ŋ̊ k ʏ ð ʏ
bönkum	p œ ŋ̊ k ʏ m
bönkunum	p œ ŋ̊ k ɔ n ʏ m
dagbókarfærslur	t a ɣ p ɔ u k a r f a j r̥ s t l ʏ r
dagbókarfærslur	t a ɣ p ɔ u k a r f a j r̥ s t l ʏ r
daginn	t aː j ɪ n
daglangt	t a ɣ l a ŋ̊ t
dagmóður	t a ɣ m ɔː u ð ʏ r
dalabræður	t aː l a p r a j ð ʏ r
dangla	t a ŋ l a
danglaði	t a ŋ l a ð ɪ
dansgólf	t a n s k ɔ u l v
dansnótta	t a n s t n ɔ u h t a
dauðahaf	t œː j ð a h a v
dauðarokkara	t œː j ð a r ɔ h k a r a
dauðaslys	t œː j ð a s t l ɪ s
dauðastjarnan	t œː j ð a s t j a r t n a n
dauðastjörnunni	t œː j ð a s t j œ r t n ʏ n ɪ
dauðateygjum	t œː j ð a tʰ ɛ j ʏ m
dauðateygjum	t œː j ð a tʰ ɛ j ʏ m
dauðdagi	t œy ð t a j ɪ
dauðlangaði	t œy ð l a ŋ k a ð ɪ
dauðlangar	t œy ð l a ŋ k a r
dauf	t œː j v
daus	t œː j s
davíðsdóttur	t aː v i ð s t ɔ u h t ʏ r
dálkaheitið	t au l̥ k a h ɛ j t ɪ ð
dánarlíkur	t aː u n a r l iː k ʏ r
dásemd	t aː u s ɛ m t
debetkortareikning	t ɛː p ɛ t kʰ ɔ r̥ t a r ɛ j h k n i ŋ k
deiginu	t ɛ j ɪ n ʏ
deildarfundir	t ɛ j l t a r f ʏ n t ɪ r
deildarkeppnin	t ɛ j l t a r cʰ ɛ h p n ɪ n
deildarleiki	t ɛ j l t a r l ɛː j c ɪ
deildarlækna	t ɛ j l t a r l a j h k n a
deildarlækna	t ɛ j l t a r l a j h k n a
deildaskipting	t ɛ j l t a s c ɪ f t i ŋ k
deildstjóra	t ɛ j l t s t j ɔː u r a
deildstjóra	t ɛ j l t s t j ɔː u r a
deilitalning	t ɛː j l ɪ tʰ a l n i ŋ k
dekurrófa	t ɛː k ʏ r ɔː u a
dekurrófu	t ɛː k ʏ r ɔː u ʏ
desemberuppbótina	t ɛː s ɛ m p ɛ r ʏ h p ɔ u t ɪ n a
diplóma	t ɪ h p l ɔ u m a
dílkrókur	t i l kʰ r ɔː u k ʏ r
djókur	t j ɔː u k ʏ r
Djúpavogi	t j uː p a v ɔː j ɪ
djúpsteiktir	t j uː p s t ɛ j x t ɪ r
djúpsteiktur	t j uː p s t ɛ j x t ʏ r
djöflaeyjunni	t j œ p l a ɛː j ʏ n ɪ
dofradóttur	t ɔ v r a t ɔ u h t ʏ r
dong	t ɔ ŋ
dóberman	t ɔː u p ɛ r m a n
dómaranámskeið	t ɔː u m a r a n au m s c ɛ j ð
dómaranámskeið	t ɔː u m a r a n au m s c ɛ j ð
dómaranefndar	t ɔː u m a r a n ɛ m t a r
dómblað	t ɔ u m p l a ð
dómkirkjur	t ɔ u m cʰ ɪ r̥ c ʏ r
dómkirkjutorgið	t ɔ u m cʰ ɪ r̥ c ʏ t ɔ r c ɪ ð
dómsalurinn	t ɔ u m s a l ʏ r ɪ n
dómsfrestunar	t ɔ u m s f r ɛ s t ʏ n a r
dómsgerðirnar	t ɔ u m s c ɛ r ð ɪ t n a r
dómskerfisins	t ɔ u m s cʰ ɛ r v ɪ s ɪ n s
dómsvaldsins	t ɔ u m s v a l t s ɪ n s
dóninn	t ɔː u n ɪ n
dópbæli	t ɔː u p a j l ɪ
dópbæli	t ɔː u p a j l ɪ
dóphundurinn	t ɔː u p h ʏ n t ʏ r ɪ n
dragi	t r aː j ɪ
dragið	t r aː j ɪ ð
dragist	t r aː j ɪ s t
dragnótabátunum	t r a ɣ n ɔ u t a p aː u t ɔ n ʏ m
dragnótabátunum	t r a ɣ n ɔ u t a p aː u t ɔ n ʏ m
drakó	t r aː k ɔ u
dramblæti	t r a m p l a j t ɪ
Drangey	t r a ŋ k ei
Drangsnesi	t r a ŋ s t n ɛ s ɪ
draugabox	t r œː j ɣ a p ɔ k s
draugagang	t r œː j ɣ a k au ŋ k
draugur	t r œː j ɣ ʏ r
draumabíllinn	t r œː j m a p i t l ɪ n
draumaeign	t r œː j m a ɛ j k n̥
draumaeign	t r œː j m a ɛ j k n̥
draumaheimi	t r œː j m a h ɛː j m ɪ
draumaheimi	t r œː j m a h ɛː j m ɪ
draumleik	t r œ j m l ɛ j k
draumleik	t r œ j m l ɛ j k
draupnir	t r œ j h p n ɪ r
draupnis	t r œ j h p n ɪ s
drápshnífa	t r aː u p s n̥ iː v a
dreifarinn	t r ɛː j f a r ɪ n
dreifigæðin	t r ɛː j v ɪ c aː j ð ɪ n
dreifigæðin	t r ɛː j v ɪ c aː j ð ɪ n
dreifilykli	t r ɛː j v ɪ l ɪ h k l ɪ
dreifingarstöð	t r ɛː j v i ŋ k a r s t œː ð
dreifitala	t r ɛː j v ɪ tʰ aː l a
dreitil	t r ɛː j t ɪ l
drenghnokka	t r ɛ j ŋ k n̥ ɔ h k a
drengjasveit	t r ɛ j ɲ c a s v ɛː j t
drengtetrinu	t r ɛ j ŋ̊ k tʰ ɛː t r ɪ n ʏ
drepleiðinleg	t r ɛː p l ɛː j ð ɪ n l ɛ ɣ
dreyra	t r ɛː j r a
dreyri	t r ɛː j r ɪ
dropasteins	t r ɔː p a s t ɛ j n s
drykkjarhæft	t r ɪ h c a r h a j f t
drykkjubræðra	t r ɪ h c ʏ p r a j ð r a
dufttæki	t ʏ f h tʰ a j c ɪ
dugi	t ʏː j ɪ
dugir	t ʏː j ɪ r
dulfræðilega	t ʏ l f r a j ð ɪ l ɛ ɣ a
dúfnaveislan	t u p n a v ɛ j s t l a n
dúfuhljóð	t uː ʏ l̥ j ɔː u ð
dúnhærð	t u n h a j r ð
dvalarheimilisins	t v aː l a r h ɛː j m ɪ l ɪ s ɪ n s
dyrhólaey	t ɪː r h ɔː u l a ɛ j
dyrhólaey	t ɪː r h ɔː u l a ɛ j
dýraheilbrigðiseftirlit	t iː r a h ɛ j l p r ɪ ɣ ð ɪ s ɛ f t ɪ r l ɪ t
dýralæknadeild	t iː r a l a j h k n a t ɛ j l t
dýralæknadeild	t iː r a l a j h k n a t ɛ j l t
dýralæknis	t iː r a l a j h k n ɪ s
dýrasjúkdóma	t iː r a s j uː k t ɔ u m a
dýratilraunir	t iː r a tʰ ɪ l r œ j n ɪ r
dýrleifu	t i r l ɛ j v ʏ
dægrastyttingu	t a j ɣ r a s t ɪ h t i ŋ k ʏ
dægurbaráttunni	t aː j ɣ ʏ r p aː r au h t ʏ n ɪ
dælingu	t aː j l i ŋ k ʏ
dælu	t aː j l ʏ
dökkgræna	t œ h k r a j n a
dökkhærðar	t œ h k h a j r ð a r
dökkhærðir	t œ h k h a j r ð ɪ r
dökkrauð	t œ h k r œ j ð
edduverðlaunahafar	ɛ t ʏ v ɛ r ð l œ j n a h aː v a r
efnafræðilega	ɛ p n a f r aː j ð ɪ l ɛ ɣ a
efnaskiptasjúkdóma	ɛ p n a s c ɪ f t a s j uː k t ɔ u m a
efnaverkfræðingur	ɛ p n a v ɛ r̥ k f r a j ð i ŋ k ʏ r
efnisgreinamerki	ɛ p n ɪ s k r ɛ j n a m ɛ r̥ c ɪ
efnisheiminn	ɛ p n ɪ s h ɛ j m ɪ n
efnisprófanir	ɛ p n ɪ s pʰ r ɔː u a n ɪ r
eftirlaunagreiðslur	ɛ f t ɪ r l œː j n a k r ɛ j ð s t l ʏ r
eftirlaunagreiðslur	ɛ f t ɪ r l œː j n a k r ɛ j ð s t l ʏ r
eftirlitsheimildir	ɛ f t ɪ r l ɪ t s h ɛ j m ɪ l t ɪ r
eftirlætisbarn	ɛ f t ɪ r l aː j t ɪ s p a t n̥
eftirmæli	ɛ f t ɪ r m aː j l ɪ
eftirvæntingarfullir	ɛ f t ɪ r v a j n̥ t i ŋ k a r f ʏ t l ɪ r
eftirvæntingarfullt	ɛ f t ɪ r v a j n̥ t i ŋ k a r f ʏ l̥ t
eggheimta	ɛ k h ɛ j m̥ t a
eggjalaust	ɛ c a l œ j s t
egó	ɛː k ɔ u
eigendaskipti	ɛː j ɣ ɛ n t a s c ɪ f t ɪ
eigendaskrá	ɛː j ɣ ɛ n t a s k r au
eiginfjárhlutfallið	ɛ j ɪ n f j au r l̥ ʏː t f a t l ɪ ð
eiginhagsmunir	ɛ j ɪ n h a x s m ʏ n ɪ r
eignaraðilar	ɛ j k n a r aː ð ɪ l a r
eignarföll	ɛ j k n a r f œ t l̥
eignarhlutdeildar	ɛ j k n a r l̥ ʏː t ɛ j l t a r
eignarhlutnum	ɛ j k n a r l̥ ʏ h t n ʏ m
eignarhöft	ɛ j k n a r h œ f t
eignarskattsfrjáls	ɛ j k n a s k a h t s f r j au l s
eignaskatt	ɛ j k n a s k a h t
eika	ɛː j k a
eikargrillaður	ɛː j k a r k r ɪ l a ð ʏ r
einangra	eiː n a ŋ k r a
einangrað	eiː n a ŋ k r a ð
einangraðir	eiː n a ŋ k r a ð ɪ r
einangraður	eiː n a ŋ k r a ð ʏ r
einangrarar	ɛː j n au ŋ k r a r a r
einangrari	ɛː j n au ŋ k r a r ɪ
einangrast	eiː n a ŋ k r a s t
einangruð	eiː n a ŋ k r ʏ ð
einangrun	eiː n a ŋ k r ʏ n
einangrunar	eiː n a ŋ k r ʏ n a r
einangrunarefnið	ɛː j n au ŋ k r ʏ n a r ɛ p n ɪ ð
einarsen	ɛː j n a r s ɛ n
einbeittari	ɛ j m p ɛ j h t a r ɪ
eindir	ɛ j n t ɪ r
einfaldasta	ɛ j n f a l t a s t a
einfaldra	ɛ j n f a l t r a
einhleyp	ɛ j n l̥ ɛː j p
einhleypum	ɛ j n l̥ ɛː j p ʏ m
einhljóð	ɛ j n l̥ j ɔ u ð
einhljóð	ɛ j n l̥ j ɔ u ð
einhneppa	ɛ j n n̥ ɛ h p a
einiber	ɛː j n ɪ p ɛ r
einingakerfi	ɛː j n i ŋ k a cʰ ɛ r v ɪ
einingaverð	ɛː j n i ŋ k a v ɛ r ð
einingaverksmiðja	ɛː j n i ŋ k a v ɛ r̥ k s m ɪ ð j a
einingaverksmiðjuna	ɛː j n i ŋ k a v ɛ r̥ k s m ɪ ð j ʏ n a
einingin	ɛː j n i ɲ c ɪ n
einka	ɛ j ŋ̊ k a
einkabíls	ɛ j ŋ̊ k a p i l s
einkabílstjóra	ɛ j ŋ̊ k a p i l s t j ɔ u r a
einkabílstjóra	ɛ j ŋ̊ k a p i l s t j ɔ u r a
einkaeyju	ɛ j ŋ̊ k a ɛː j ʏ
einkaflugmanninn	ɛ j ŋ̊ k a f l ʏ ɣ m a n ɪ n
einkafundir	ɛ j ŋ̊ k a f ʏ n t ɪ r
einkakennslu	ɛ j ŋ̊ k a cʰ ɛ n s t l ʏ
einkaleyfastofan	ɛ j ŋ̊ k a l ɛ j v a s t ɔː v a n
einkaleyfastofunni	ɛ j ŋ̊ k a l ɛ j v a s t ɔː v ʏ n ɪ
einkaleyfum	ɛ j ŋ̊ k a l ɛ j v ʏ m
einkanúmer	ɛ j ŋ̊ k a n uː m ɛ r
einkanúmerinu	ɛ j ŋ̊ k a n uː m ɛ r ɪ n ʏ
einkastarfssemin	ɛ j ŋ̊ k a s t a r s ɛ m ɪ n
einkaumboð	ɛ j ŋ̊ k a ʏ m p ɔ ð
einkaumboð	ɛ j ŋ̊ k a ʏ m p ɔ ð
einkavætt	ɛ j ŋ̊ k a v a j h t
einkavætt	ɛ j ŋ̊ k a v a j h t
einkennissmellu	ɛ j ɲ cʰ ɛ n ɪ s m ɛ t l ʏ
einkennisstafina	ɛ j ɲ cʰ ɛ n ɪ s t aː v ɪ n a
einkjarna	ɛ j ɲ cʰ a r t n a
einkunnaafhending	ɛ j ŋ̊ k ʏ n a a f h ɛ n t i ŋ k
einkunnar	ɛ j ŋ̊ k ʏ n a r
einkunnirnar	ɛ j ŋ̊ k ʏ n ɪ t n a r
einleikstónleika	ɛ j n l ɛ j k s tʰ ɔ u n l ɛ j k a
einleikstónleika	ɛ j n l ɛ j k s tʰ ɔ u n l ɛ j k a
einlit	ɛ j n l ɪ t
einlífi	ɛ j n l i v ɪ
einmenningstölvum	ɛ j n m ɛ n i ŋ s t œ l v ʏ m
einrækta	ɛ j n r a j x t a
einrækta	ɛ j n r a j x t a
einsagan	ɛ j n s a ɣ a n
einskisnýtum	ɛ j n s c ɪ s t n iː t ʏ m
einstaklingsaðild	ɛ j n s t a h k l i ŋ s aː ð ɪ l t
einstaklingshjálp	ɛ j n s t a h k l i ŋ k s ç au l̥ p
einstaklingunum	ɛ j n s t a h k l i ŋ k ɔ n ʏ m
einsteinunga	ɛ j n s t ɛ j n u ŋ k a
einstofna	ɛ j n s t ɔ p n a
einstæðingar	ɛ j n s t a j ð i ŋ k a r
einstæðingar	ɛ j n s t a j ð i ŋ k a r
einteinunga	ɛ j n tʰ ɛː j n u ŋ k a
eintölu	ɛ j n tʰ œ l ʏ
eintölumynd	ɛ j n tʰ œ l ʏ m ɪ n t
einyrkja	ɛ j n ɪ r̥ c a
einyrkjar	ɛ j n ɪ r̥ c a r
eirkerinu	ɛ j r cʰ ɛː r ɪ n ʏ
eistlendinganna	ɛ j s t l ɛ n t i ŋ k a n a
eiturdali	ɛː j t ʏ r t aː l ɪ
eiturhress	ɛː j t ʏ r̥ ɛ s
eiturlyfjabaróninn	ɛː j t ʏ r l ɪ v j a p a r ɔː u n ɪ n
eiturlyfjabaróninn	ɛː j t ʏ r l ɪ v j a p a r ɔː u n ɪ n
eiturlyfjasmygli	ɛː j t ʏ r l ɪ v j a s m ɪ k l ɪ
eiturnöðrur	ɛː j t ʏ r t n œ ð r ʏ r
eitursvalir	ɛː j t ʏ r s v aː l ɪ r
ekkasogin	ɛ h k a s ɔː j ɪ n
eldey	ɛ l t ɛ j
eldeyjarboða	ɛ l t ɛ j a r p ɔː ð a
eldflaugafræðingur	ɛ l t f l œ j ɣ a f r aː j ð i ŋ k ʏ r
eldflaugafræðingur	ɛ l t f l œ j ɣ a f r aː j ð i ŋ k ʏ r
eldgleypir	ɛ l t c l ɛ j p ɪ r
eldhúskrókur	ɛ l t h u s kʰ r ɔː u k ʏ r
eldhættan	ɛ l t h a j h t a n
eldmóð	ɛ l t m ɔː u ð
eldsneytisgeymir	ɛ l t s t n ɛ j t ɪ s k ɛ j m ɪ r
eldsneytistank	ɛ l t s t n ɛ j t ɪ s t au ŋ̊ k
eldsneytistegunda	ɛ l t s t n ɛ j t ɪ s t ɛː ɣ ʏ n t a
eldsneytisverð	ɛ l t s t n ɛ j t ɪ s v ɛ r ð
eldtraustleika	ɛ l tʰ r œ j s t l ɛ j k a
eldtraustleika	ɛ l tʰ r œ j s t l ɛ j k a
eldunarsteinarnir	ɛ l t ʏ n a r s t ɛ j n a t n ɪ r
embættisbréfunum	ɛ m p a j h t ɪ s p r j ɛː v ɔ n ʏ m
embættisvaldi	ɛ m p a j h t ɪ s v a l t ɪ
embættisverk	ɛ m p a j h t ɪ s v ɛ r̥ k
emstruá	ɛ m s t r ʏ aː u
endalagið	ɛ n t a l a j ɪ ð
endilanga	ɛ n t ɪ l a ŋ k a
endilangan	ɛ n t ɪ l a ŋ k a n
endilangt	ɛ n t ɪ l a ŋ̊ t
endingargóðar	ɛ n t i ŋ k a r k ɔː u ð a r
endurgreidd	ɛ n t ʏ r k r ɛ j t
endurheimtur	ɛ n t ʏ r h ɛ j m̥ t ʏ r
endurhæfingarinnar	ɛ n t ʏ r h aː j v i ŋ k a r ɪ n a r
endurmein	ɛ n t ʏ r m ɛ j n
endurmenntunardeildin	ɛ n t ʏ r m ɛ n̥ t ʏ n a r t ɛ j l t ɪ n
endurreiknað	ɛ n t ʏ r ɛ j h k n a ð
endurreisnarráð	ɛ n t ʏ r ɛ j s t n a r aː u ð
endurreisnarráð	ɛ n t ʏ r ɛ j s t n a r aː u ð
endurrækta	ɛ n t ʏ r a j x t a
endurræsingu	ɛ n t ʏ r aː j s i ŋ k ʏ
endurskilgreiningar	ɛ n t ʏ r s c ɪ l k r ɛ j n i ŋ k a r
engiferi	ɛ j ɲ c ɪ f ɛː r ɪ
engiferinu	ɛ j ɲ c ɪ f ɛː r ɪ n ʏ
engilbertsdóttir	ɛ j ɲ c ɪ l p ɛ r̥ t s t ɔ u h t ɪ r
engilbertsdóttir	ɛ j ɲ c ɪ l p ɛ r̥ t s t ɔ u h t ɪ r
engilhreint	ɛ j ɲ c ɪ l r̥ ɛ j n̥ t
engisbrekkum	ɛ j ɲ c ɪ s p r ɛ h k ʏ m
engjar	ɛ j ɲ c a r
engjaþykkni	ɛ j ɲ c a θ ɪ h k n ɪ
englaborg	ɛ j ŋ l a p ɔ r k
englamyndirnar	ɛ j ŋ l a m ɪ n t ɪ t n a r
englandsbanki	ɛ j ŋ l a n t s p au ɲ c ɪ
englandsmeistaratitil	ɛ j ŋ l a n t s m ɛ j s t a r a tʰ ɪː t ɪ l
epóstur	ɛ pʰ ɔ u s t ʏ r
erfðarannsókn	ɛ r ð a r a n s ɔ u h k n̥
erkióvininum	ɛ r̥ c ɪ ɔː u v ɪ n ɪ n ʏ m
esradóttir	ɛː s r a t ɔ u h t ɪ r
essó	ɛ s ɔ u
evangelísk	ɛː v a ɲ c ɛ l i s k
evangelískir	ɛː v a ɲ c ɛ l i s c ɪ r
evrópski	ɛ v r ɔ u p s c ɪ
evrópsks	ɛ v r ɔ u s k s
evrópubandalagið	ɛ v r ɔ u p ʏ p a n t a l a j ɪ ð
evrópubandalagið	ɛ v r ɔ u p ʏ p a n t a l a j ɪ ð
evrópubandalagsins	ɛ v r ɔ u p ʏ p a n t a l a x s ɪ n s
evrópubikarliðinu	ɛ v r ɔ u p ʏ p ɪː k a r t l ɪː ð ɪ n ʏ
evrópubílarnir	ɛ v r ɔ u p ʏ p iː l a t n ɪ r
evrópudeild	ɛ v r ɔ u p ʏ t ɛ j l t
evrópudeild	ɛ v r ɔ u p ʏ t ɛ j l t
evrópudeildar	ɛ v r ɔ u p ʏ t ɛ j l t a r
evrópudeildar	ɛ v r ɔ u p ʏ t ɛ j l t a r
evrópuhöfnin	ɛ v r ɔ u p ʏ h œ p n ɪ n
evrópukeppnin	ɛ v r ɔ u p ʏ cʰ ɛ h p n ɪ n
evrópukvikmyndir	ɛ v r ɔ u p ʏ kʰ v ɪ k m ɪ n t ɪ r
evrópumeistaratitilinn	ɛ v r ɔ u p ʏ m ɛ j s t a r a tʰ ɪː t ɪ t l ɪ n
evrópumeistaratitilinn	ɛ v r ɔ u p ʏ m ɛ j s t a r a tʰ ɪː t ɪ t l ɪ n
evrópumóts	ɛ v r ɔ u p ʏ m ɔ u t s
evrópusamband	ɛ v r ɔ u p ʏ s a m p a n t
evrópusambands	ɛ v r ɔ u p ʏ s a m p a n t s
evrópustaðlasamtökunum	ɛ v r ɔ u p ʏ s t a ð l a s a m tʰ œ k ɔ n ʏ m
evrópusæti	ɛ v r ɔ u p ʏ s a j t ɪ
evrópusæti	ɛ v r ɔ u p ʏ s a j t ɪ
evróputúrnum	ɛ v r ɔ u p ʏ t u r t n ʏ m
evrópuverkefninu	ɛ v r ɔ u p ʏ v ɛ r̥ k ɛ p n ɪ n ʏ
expó	ɛ k s p ɔ u
eyjadal	ɛ j a t aː l
eyjafjarðardeildar	ɛ j a f j a r ð a r t ɛ j l t a r
eyjaklasinn	ɛ j a kʰ l aː s ɪ n
eyjalína	ɛ j a l iː n a
eyjastelpu	ɛ j a s t ɛ l̥ p ʏ
eyjólfsstaðir	ɛː j ɔ u l s t aː ð ɪ r
eyjólfsstaðir	ɛː j ɔ u l s t aː ð ɪ r
eymdanna	ɛ j m t a n a
eymsla	ɛ j m s t l a
eyrans	ɛː j r a n s
eyrarfell	ɛː j r a r f ɛ t l̥
eyrarfjall	ɛː j r a r f j a t l̥
eyrarskjóli	ɛː j r a r s c ɔː u l ɪ
eyrarskjóli	ɛː j r a r s c ɔː u l ɪ
eyrarskjóls	ɛː j r a r s c ɔ u l s
eyrarskjóls	ɛː j r a r s c ɔ u l s
eyrnabólgan	ɛ j r t n a p ɔ u l k a n
eyrnabólgan	ɛ j r t n a p ɔ u l k a n
eyrnalokka	ɛ j r t n a l ɔ h k a
eyrnalyf	ɛ j r t n a l ɪː v
eyrnaveseni	ɛ j r t n a v ɛː s ɛ n ɪ
eyrugla	ɛː j r ʏ k l a
faðmlagi	f a ð m l a j ɪ
faðmlagið	f a ð m l a j ɪ ð
faðmlögin	f a ð m l œ j ɪ n
fagfjárfestasjóðurinn	f a ɣ f j au r f ɛ s t a s j ɔː u ð ʏ r ɪ n
faggreinar	f a ɣ k r ɛ j n a r
faghóps	f aː ɣ h ɔ u p s
faghópum	f aː ɣ h ɔ u p ʏ m
faghópur	f aː ɣ h ɔ u p ʏ r
fagi	f aː j ɪ
fagið	f aː j ɪ ð
faginu	f aː j ɪ n ʏ
fagnámskeið	f a ɣ n au m s c ɛ j ð
fagráð	f a ɣ r aː u ð
fagtengdar	f a ɣ tʰ ɛ j ŋ t a r
fagtengdi	f a ɣ tʰ ɛ j ŋ t ɪ
fagurfræðinginn	f aː ɣ ʏ r f r a j ð i ɲ c ɪ n
fagurrauður	f aː ɣ ʏ r œ j ð ʏ r
fallhæðin	f a t l̥ h a j ð ɪ n
fang	f a ŋ k
fanga	f a ŋ k a
fangabúðir	f a ŋ k a p uː ð ɪ r
fangabúðum	f a ŋ k a p uː ð ʏ m
fangað	f a ŋ k a ð
fangaði	f a ŋ k a ð ɪ
fangageymslu	f a ŋ k a c ei m s t l ʏ
fangaklefa	f a ŋ k a k l ɛː v a
fangana	f a ŋ k a n a
fangann	f a ŋ k a n
fanganna	f a ŋ k a n a
fangar	f a ŋ k a r
fangarnir	f a ŋ k a t n ɪ r
fangavagninum	f a ŋ k a v a k n ɪ n ʏ m
fangaverðirnir	f a ŋ k a v ɛ r ð ɪ t n ɪ r
fangavörðurinn	f a ŋ k a v œ r ð ʏ r ɪ n
fangelsaður	f a ɲ c ɛ l s a ð ʏ r
fangelsi	f a ɲ c ɛ l s ɪ
fangelsið	f a ɲ c ɛ l s ɪ ð
fangelsinu	f a ɲ c ɛ l s ɪ n ʏ
fangelsisdóm	f a ɲ c ɛ l s ɪ s t ouː m
fangelsisvist	f a ɲ c ɛ l s ɪ s v ɪ s t
fangelsisvistar	f a ɲ c ɛ l s ɪ s v ɪ s t a r
fangelsum	f a ɲ c ɛ l s ʏ m
fangi	f a ɲ c ɪ
fangið	f a ɲ c ɪ ð
fanginn	f a ɲ c ɪ n
fanginni	f a ɲ c ɪ n ɪ
fanginu	f a ɲ c ɪ n ʏ
fanneyjar	f a n ɛ j a r
farangri	f aː r a ŋ k r ɪ
farangrinum	f aː r a ŋ k r ɪ n ʏ m
farangur	f aː r a ŋ k ʏ r
farangurinn	f aː r a ŋ k ʏ r ɪ n
fararstjórar	f aː r a r s t j ɔː u r a r
farartækjaeftirlit	f aː r a r tʰ a j c a ɛ f t ɪ r l ɪ t
farfuglaheimilið	f a r f ʏ k l a h ɛ j m ɪ l ɪ ð
farsímafyrirtækið	f a r̥ s i m a f ɪː r ɪ r tʰ aː j c ɪ ð
farsímafyrirtækja	f a r̥ s i m a f ɪː r ɪ r tʰ aː j c a
farsímaleikjum	f a r̥ s i m a l ɛ j c ʏ m
farsæls	f a r̥ s a j l s
fasteignamiðlun	f a s t ɛ j k n a m ɪ ð l ʏ n
fasteignaskatts	f a s t ɛ j k n a s k a h t s
fasteignina	f a s t ɛ j k n ɪ n a
fatahreinsunina	f aː t a r̥ ɛ j n s ʏ n ɪ n a
faxtæki	f a k s tʰ a j c ɪ
fátækir	f aiː t ai c ɪ r
feigðarósi	f ɛ j ɣ ð a r ɔː u s ɪ
feigðarósi	f ɛ j ɣ ð a r ɔː u s ɪ
feigðin	f ɛ j ɣ ð ɪ n
feilpúst	f ɛ j l pʰ u s t
feilspor	f ɛ j l s p ɔ r
feitlagin	f eiː t l a j ɪ n
feitlaginn	f eiː t l a j ɪ n
feneyjar	f ɛː n ɛ j a r
ferðalagi	f ɛ r ð a l aː j ɪ
ferðalagið	f ɛ r ð a l aː j ɪ ð
ferðalaginu	f ɛ r ð a l aː j ɪ n ʏ
ferðalang	f ɛ r ð a l a ŋ k
ferðalanga	f ɛ r ð a l a ŋ k a
ferðalangar	f ɛ r ð a l a ŋ k a r
ferðalangarnir	f ɛ r ð a l a ŋ k a t n ɪ r
ferðalangur	f ɛ r ð a l a ŋ k ʏ r
ferðalögin	f ɛ r ð a l œː j ɪ n
ferðalöngum	f ɛ r ð a l œ ŋ k ʏ m
ferjutengingin	f ɛ r j ʏ tʰ ɛ j ɲ c i ɲ c ɪ n
ferningsrætur	f ɛ r t n i ŋ s r a j t ʏ r
feykisterkt	f ɛː j c ɪ s t ɛ r̥ t
feykja	f ɛː j c a
félagins	f j ɛː l a ɣ s ɪ n s
félaginu	f j ɛː l a j ɪ n ʏ
fimleikadeild	f ɪ m l ɛ j k a t ɛ j l t
fimleikaeltingarleik	f ɪ m l ɛ j k a ɛ l̥ t i ŋ k a r l ɛː j k
fimleikakeppni	f ɪ m l ɛ j k a cʰ ɛ h p n ɪ
fimmstæð	f ɪ m s t a j ð
fimmtudaginn	f ɪ m̥ t ʏ t aː j ɪ n
Finnbogi	f ɪ m p ɔ j ɪ
fiskdælur	f ɪ s k t a j l ʏ r
fiskibátur	f ɪ s c ɪ p aː u t ʏ r
fiskimálum	f ɪ s c ɪ m aː u l ʏ m
fisksjúkdómayfirvalda	f ɪ s k s j u k t ɔ u m a ɪː v ɪ r v a l t a
fiskveiðistefna	f ɪ s k v ɛ j ð ɪ s t ɛ p n a
fiskveiðistofnunarinnar	f ɪ s k v ɛ j ð ɪ s t ɔ p n ʏ n a r ɪ n a r
fitumæling	f ɪː t ʏ m a j l i ŋ k
fitumælingu	f ɪː t ʏ m a j l i ŋ k ʏ
fjallafólksins	f j a t l a f ɔ u l̥ k s ɪ n s
fjallahjólum	f j a t l a ç ɔː u l ʏ m
fjallakjóa	f j a t l a cʰ ɔː u a
fjallasvæðin	f j a t l a s v aː j ð ɪ n
fjallgöngumanna	f j a t l̥ k œ j ŋ k ʏ m a n a
fjarðarkaupa	f j a r ð a r kʰ œː j p a
fjarkennslustjórar	f j a r̥ cʰ ɛ n s t l ʏ s t j ɔː u r a r
fjarlægið	f j a r l aː j ɪ ð
fjarskiptamálum	f j a r̥ s c ɪ f t a m aː u l ʏ m
fjárbókin	f j au r p ɔ u c ɪ n
fjárfestingaeignir	f j au r̥ f ɛ s t i ŋ k a ɛ j k n ɪ r
fjárfestingatækifæri	f j au r̥ f ɛ s t i ŋ k a tʰ aː j c ɪ f aː j r ɪ
fjárhjör	f j aː u r ç œː r
fjárhlut	f j aː u r l̥ ʏː t
fjárhunda	f j aː u r h ʏ n t a
fjárhundur	f j aː u r h ʏ n t ʏ r
fjármagnseigenda	f j au r m a k s ɛ j ɣ ɛ n t a
fjármagnshreyfingum	f j au r m a k s r̥ ɛː j v i ŋ k ʏ m
fjármálafyrirtækis	f j au r m au l a f ɪː r ɪ r tʰ aː j c ɪ s
fjármálaráðuneytis	f j au r m au l a r aː u ð ʏ n ɛː j t ɪ s
fjármálastjórar	f j au r m au l a s t j ɔː u r a r
fjártjóns	f j au r̥ t j ɔ u n s
fjórhjóladrif	f j ɔ u r ç ɔː u l a t r ɪː v
fjórprófinu	f j ɔ u r̥ p r ɔː u ɪ n ʏ
fjórskiptan	f j ɔ u r̥ s c ɪ f t a n
fjórskorin	f j ɔ u r̥ s k ɔ r ɪ n
fjósa	f j ɔː u s a
fjósdyr	f j ɔː u s t ɪ r
fjósheyið	f j ɔː u s h ɛ j ɪ ð
fjósheyið	f j ɔː u s h ɛ j ɪ ð
fjóss	f j ɔ u s
fjölbrautarkerfis	f j œ l p r œ j t a r cʰ ɛ r v ɪ s
fjölbreytilegum	f j œ l p r ɛ j t ɪ l ɛ ɣ ʏ m
fjölbreytileiki	f j œ l p r ɛ j t ɪ l ɛː j c ɪ
fjölbreytninni	f j œ l p r ɛ j h t n ɪ n ɪ
fjölbreytts	f j œ l p r ɛ j h t s
fjöldaframleidd	f j œ l t a f r a m l ɛ j t
fjölgreinadeild	f j œ l k r ɛ j n a t ɛ j l t
fjölmiðlamálinu	f j œ l m ɪ ð l a m aː u l ɪ n ʏ
fjölmiðlunarfyrirtækið	f j œ l m ɪ ð l ʏ n a r f ɪː r ɪ r tʰ aː j c ɪ ð
fjölskyldueiningarnar	f j œ l s c ɪ l t ʏ ɛ j n i ŋ k a t n a r
fjölskylduheimili	f j œ l s c ɪ l t ʏ h ɛ j m ɪ l ɪ
fjölskylduleikur	f j œ l s c ɪ l t ʏ l ɛː j k ʏ r
fjölskylduvænar	f j œ l s c ɪ l t ʏ v aː j n a r
fjölstjórnarumhverfi	f j œ l s t j ɔ u r t n a r ʏ m kʰ v ɛ r v ɪ
fjöltækniskóli	f j œ l tʰ a j h k n ɪ s k ɔː u l ɪ
fjöltækniskóli	f j œ l tʰ a j h k n ɪ s k ɔː u l ɪ
fjölveiðiskip	f j œ l v ɛ j ð ɪ s c ɪː p
fjölveiðiskipi	f j œ l v ɛ j ð ɪ s c ɪː p ɪ
fjölvöðvagigtar	f j œ l v œ ð v a c ɪ x t a r
fjörmjólk	f j œ r m j ɔ u l̥ k
fjörubeit	f j œː r ʏ p ɛː j t
flagið	f l a j ɪ ð
flatbrauð	f l aː t p r œ j ð
flateyjardal	f l aː t ɛ j a r t aː l
flauganna	f l œː j ɣ a n a
flautara	f l œː j t a r a
flensusprauturnar	f l ɛ n s ʏ s p r œː j t ʏ t n a r
fleygar	f l ɛː j ɣ a r
fljótan	f l j ɔː u t a n
fljótleg	f l j ɔː u t l ɛ ɣ
fljótlegu	f l j ɔː u t l ɛ ɣ ʏ
fljótsdalsgrund	f l j ɔ u s t a l s k r ʏ n t
fljótsdalur	f l j ɔ u s t a l ʏ r
fljótvirkur	f l j ɔː u t v ɪ r̥ k ʏ r
flogaveikilyf	f l ɔː ɣ a v ɛː j c ɪ l ɪː v
flogið	f l ɔː j ɪ ð
flokkaleikur	f l ɔ h k a l ɛː j k ʏ r
flokkameistari	f l ɔ h k a m ɛ j s t a r ɪ
flóans	f l ɔː u a n s
flókabendu	f l ɔː u k a p ɛ n t ʏ
flókahnykill	f l ɔː u k a n̥ ɪː c ɪ t l̥
flókajötnar	f l ɔː u k a j œ h t n a r
flókinna	f l ɔː u c ɪ n a
flókinni	f l ɔː u c ɪ n ɪ
flóknasta	f l ɔ u h k n a s t a
flórídaskaga	f l ɔː u r i t a s k aː ɣ a
flórristar	f l ɔ u r ɪ s t a r
flóttahyggja	f l ɔ u h t a h ɪ c a
flugakbraut	f l ʏː ɣ a k p r œ j t
flugbrautina	f l ʏ ɣ p r œ j t ɪ n a
flugdrekahlauparann	f l ʏ ɣ t r ɛ kʰ a l̥ œ j p a r a n
flugfélagi	f l ʏ x f j ɛ l a j ɪ
flugfélagið	f l ʏ x f j ɛ l a j ɪ ð
flugfélaginu	f l ʏ x f j ɛ l a j ɪ n ʏ
flugi	f l ʏː j ɪ
flugið	f l ʏː j ɪ ð
fluginu	f l ʏː j ɪ n ʏ
flugmálahandbókarinnar	f l ʏ ɣ m au l a h a n t p ɔ u k a r ɪ n a r
flugmálastjórna	f l ʏ ɣ m au l a s t j ɔ u r t n a
flugrekendaskírteini	f l ʏ ɣ r ɛ k ɛ n t a s c i r̥ t ɛ j n ɪ
flugrekstrarleyfi	f l ʏ ɣ r ɛ k s t r a r l ɛː j v ɪ
flugskóli	f l ʏ x s k ɔ u l ɪ
flugslysahóps	f l ʏ x s t l ɪː s a h ɔ u p s
flugstjórnarstofnunina	f l ʏ x s t j ɔ u r t n a r s t ɔ p n ʏ n ɪ n a
flúorauka	f l uː ɔ r œ j k a
flúormengun	f l uː ɔ r m ɛ j ŋ k ʏ n
flækingsfugl	f l aː j c i ŋ k s f ʏ k l̥
flækjur	f l aː j c ʏ r
flæmdu	f l a j m t ʏ
forframleiddu	f ɔ r f r a m l ɛ j t ʏ
forkaupsréttar	f ɔ r̥ kʰ œ j p s r j ɛ h t a r
forkólfum	f ɔ r̥ kʰ ɔ u l v ʏ m
forlagið	f ɔ r l a j ɪ ð
forlaginu	f ɔ r l a j ɪ n ʏ
fornfrækna	f ɔ r t n f r a j h k n a
fornleifaskráning	f ɔ r t n l ɛ j v a s k r aː u n i ŋ k
fornleifaskráning	f ɔ r t n l ɛ j v a s k r aː u n i ŋ k
fornleifaverndar	f ɔ r t n l ɛ j v a v ɛ n t a r
forritunarmáli	f ɔ r ɪ t ʏ n a r m aː u l ɪ
forsætisráðherrarnir	f ɔ r̥ s a j t ɪ s r aː u ð h ɛ r a t n ɪ r
forsætisráðherrarnir	f ɔ r̥ s a j t ɪ s r aː u ð h ɛ r a t n ɪ r
forumsóknir	f ɔː r ʏ m s ɔ u h k n ɪ r
forustusauðurinn	f ɔː r ʏ s t ʏ s œː j ð ʏ r ɪ n
forystufólks	f ɔː r ʏ s t ʏ f ɔ u l̥ k s
fosfórsúr	f ɔː s f ɔ u r s uː r
Fossvogi	f ɔ s v ɔ j ɪ
Fossvoginum	f ɔ s v ɔ j ɪ n ʏ m
framangreind	f r aː m a n k r ei n t
framangreindu	f r aː m a n k r ei n t ʏ
framangreindum	f r aː m a n k r ei n t ʏ m
framfótum	f r a m f ɔ u t ʏ m
framhaldsskólanemendur	f r a m h a l t s k ɔː u l a n ɛː m ɛ n t ʏ r
framkvæmdaeftirlits	f r a m kʰ v a j m t a ɛ f t ɪ r l ɪ t s
framkvæmdamenn	f r a m kʰ v a j m t a m ɛ n
framkvæmdaorka	f r a m kʰ v a j m t a ɔ r̥ k a
framkvæmdarliða	f r a m kʰ v a j m t a r l ɪː ð a
framkvæmdarstjórnar	f r a m kʰ v a j m t a r s t j ɔ u r t n a r
framkvæmdarstjórnar	f r a m kʰ v a j m t a r s t j ɔ u r t n a r
framkvæmdastjóraleikur	f r a m kʰ v a j m t a s t j ɔː u r a l ɛː j k ʏ r
framkvæmdastjóraleikur	f r a m kʰ v a j m t a s t j ɔː u r a l ɛː j k ʏ r
framkvæmdastjóraleikur	f r a m kʰ v a j m t a s t j ɔː u r a l ɛː j k ʏ r
framkvæmdastjóranum	f r a m kʰ v a j m t a s t j ɔː u r a n ʏ m
framkvæmdastjóranum	f r a m kʰ v a j m t a s t j ɔː u r a n ʏ m
framkvæmdastjórnarinnar	f r a m k v ai m t a
framkvæmdastjórnina	f r a m kʰ v a j m t a s t j ɔ u r t n ɪ n a
framkvæmdastjórnina	f r a m kʰ v a j m t a s t j ɔ u r t n ɪ n a
framkvæmdasýsla	f r a m kʰ v a j m t a s i s t l a
framkvæmdatíma	f r a m kʰ v a j m t a tʰ iː m a
framkvæmdatímanum	f r a m kʰ v a j m t a tʰ iː m a n ʏ m
framlagi	f r a m l a j ɪ
framlagið	f r a m l a j ɪ ð
framleiddum	f r a m l ɛ j t ʏ m
framleiðnisjóður	f r a m l ɛ j ð n ɪ s j ɔː u ð ʏ r
framleiðnisjóður	f r a m l ɛ j ð n ɪ s j ɔː u ð ʏ r
framleiðslufyrirtækjum	f r a m l ɛ j ð s t l ʏ f ɪː r ɪ r tʰ aː j c ʏ m
framleiðslufyrirtækjum	f r a m l ɛ j ð s t l ʏ f ɪː r ɪ r tʰ aː j c ʏ m
framleiðsluhæfileika	f r a m l ɛ j ð s t l ʏ h a j v ɪ l ɛː j k a
framleiðsluhæfileika	f r a m l ɛ j ð s t l ʏ h a j v ɪ l ɛː j k a
framleiðslukerfi	f r a m l ɛ j ð s t l ʏ cʰ ɛ r v ɪ
framleiðslulínunni	f r a m l ɛ j ð s t l ʏ l iː n ʏ n ɪ
framleiðslumælingakerfisins	f r a m l ɛ j ð s t l ʏ m a j l i ŋ k a cʰ ɛ r v ɪ s ɪ n s
framleiðslumælingakerfisins	f r a m l ɛ j ð s t l ʏ m a j l i ŋ k a cʰ ɛ r v ɪ s ɪ n s
framleiðslutakmarkanir	f r a m l ɛ j ð s t l ʏ tʰ aː k m a r̥ k a n ɪ r
framlengdum	f r a m l ɛ j ŋ t ʏ m
framlengingarinnar	f r a m l ɛ j ɲ c i ŋ k a r ɪ n a r
framreiðslu	f r a m r ɛ j ð s t l ʏ
framreiðslumanninn	f r a m r ɛ j ð s t l ʏ m a n ɪ n
framreitt	f r a m r ɛ j h t
framsóknarhjú	f r a m s ɔ u h k n a r ç uː
framsæta	f r a m s a j t a
framsætum	f r a m s a j t ʏ m
frank	f r a ŋ̊ k
Frankfurt	f r a ŋ̊ k f u r̥ t
Frankfurt	f r a ŋ k f u r̥ t
frankinn	f r a n̥ c ɪ n
Franklín	f r a ŋ̊ k l i n
Franklín	f r a ŋ k l i n
fransiskó	f r a n s ɪ s k ɔ u
frauð	f r œː j ð
fraus	f r œː j s
frábending	f r aː u p ɛ n t i ŋ k
fráhvarfseinkenni	f r aː u kʰ v a r s ɛ j ɲ cʰ ɛ n ɪ
fráhvarfseinkenni	f r aː u kʰ v a r s ɛ j ɲ cʰ ɛ n ɪ
frárennsliskerfum	f r aː u r ɛ n s t l ɪ s cʰ ɛ r v ʏ m
frelsishreyfingunni	f r ɛ l s ɪ s r̥ ɛː j v i ŋ k ʏ n ɪ
freygerður	f r ɛː j c ɛ r ð ʏ r
fréttaljósmyndari	f r j ɛ h t a l j ɔː u s m ʏ n t a r ɪ
fréttamannahópurinn	f r j ɛ h t a m a n a h ɔː u p ʏ r ɪ n
friðargæslumenn	f r ɪː ð a r c a j s t l ʏ m ɛ n
friðargæslustarfsins	f r ɪː ð a r c a j s t l ʏ s t a r s ɪ n s
friðargæslusveit	f r ɪː ð a r c a j s t l ʏ s v ɛː j t
friðargæslusveit	f r ɪː ð a r c a j s t l ʏ s v ɛː j t
friðarsamkomulagi	f r ɪː ð a r s a m kʰ ɔ m ʏ l a j ɪ
frjálshyggjutaug	f r j au l s h ɪ c t œː j ɣ
frjósemislyfið	f r j ɔː u s ɛ m ɪ s t l ɪː v ɪ ð
frjóvgun	f r j ɔ u v k ʏ n
frumbreytur	f r ʏ m p r ɛ j t ʏ r
frumkvæðisaðilar	f r ʏ m kʰ v a j ð ɪ s aː ð ɪ l a r
frumkvöðlafræðsla	f r ʏ m kʰ v œ ð l a f r a j ð s t l a
frumskógar	f r ʏ m s k ɔː u a r
frumugreini	f r ʏː m ʏ k r ɛː j n ɪ
frumættleiða	f r ʏː m a j h t l ɛː j ð a
frumættleiða	f r ʏː m a j h t l ɛː j ð a
frystigeymsla	f r ɪ s t ɪ c ɛ j m s t l a
fræddu	f r a j t ʏ
fræin	f r a j ɪ n
fræsa	f r aː j s a
fræsaðir	f r aː j s a ð ɪ r
fullnægi	f ʏ t l̥ n a j ɪ
fullnægingar	f ʏ t l̥ n a j i ŋ k a r
fullnægir	f ʏ t l̥ n a j ɪ r
fullstór	f ʏ t l̥ s t ɔː u r
fylgibreytu	f ɪ l c ɪ p r ɛː j t ʏ
fylginautur	f ɪ l c ɪ n œː j t ʏ r
fyrirkomulagi	f ɪː r ɪ r k ɔ m ʏ l aː j ɪ
fyrirkomulagið	f ɪː r ɪ r k ɔ m ʏ l aː j ɪ ð
fyrirtækisnafn	f ɪː r ɪ r tʰ aː j c ɪ s t n a p n̥
fyrirtækissins	f ɪː r ɪ r tʰ aː j c ɪ s ɪ n s
fyrirtækjagræðgi	f ɪː r ɪ r tʰ aː j c a k r a j ð c ɪ
fyrirtækjakaup	f ɪː r ɪ r tʰ aː j c a kʰ œː j p
fyrirtækjakaup	f ɪː r ɪ r tʰ aː j c a kʰ œː j p
föngnum	f œ ŋ k n ʏ m
fönguðu	f œ ŋ k ʏ ð ʏ
fönguleg	f œ ŋ k ʏ l ɛ ɣ
föngum	f œ ŋ k ʏ m
föngunum	f œ ŋ k ɔ n ʏ m
föstudaginn	f œ s t ʏ t aː j ɪ n
gagnabanka	k a k n a p a ŋ̊ k a
gagnabönkum	k a k n a p œ j ŋ̊ k ʏ m
gagnadulkóðun	k a k n a t ʏ l̥ kʰ ɔ u ð ʏ n
gagnagreining	k a k n a k r ɛː j n i ŋ k
gagnagrunnstækni	k a k n a k r ʏ n s t a j h k n ɪ
gagnaskráningarkerfi	k a k n a s k r aː u n i ŋ k a r cʰ ɛ r v ɪ
gagnaskrár	k a k n a s k r aː u r
gagnaugaslagæð	k a k n œ j ɣ a s t l aː ɣ a j ð
gagnaugaslagæð	k a k n œ j ɣ a s t l aː ɣ a j ð
gagnkynhneigðra	k a k n cʰ ɪ n n̥ ɛ j ɣ ð r a
galdralaukur	k a l t r a l œː j k ʏ r
gallsteinabriskirtilsbólgu	k a t l̥ s t ɛ j n a p r ɪː s c ɪ r̥ t ɪ l s p ɔ u l k ʏ
gallsteinabriskirtilsbólgu	k a t l̥ s t ɛ j n a p r ɪː s c ɪ r̥ t ɪ l s p ɔ u l k ʏ
gamanleikrit	k aː m a n l ɛː j k r ɪ t
gang	k a ŋ k
ganga	k a ŋ k a
gangan	k a ŋ k a n
gangana	k a ŋ k a n a
gangandi	k a ŋ k a n t ɪ
ganganna	k a ŋ k a n a
gangar	k a ŋ k a r
gangast	k a ŋ k a s t
gangbrautarvarsla	k au ŋ p r œː j t a r v a r̥ s t l a
gangfær	k a ŋ k f ai r
gangi	k a ɲ c ɪ
gangið	k a ɲ c ɪ ð
ganginn	k a ɲ c ɪ n
ganginum	k a ɲ c ɪ n ʏ m
gangir	k a ɲ c ɪ r
gangs	k a ŋ s
gangstétt	k a ŋ k s t j ɛ h t
gangstéttina	k a ŋ k s t j ɛ h t ɪ n a
gangstéttinni	k a ŋ k s t j ɛ h t ɪ n ɪ
gangstéttir	k a ŋ k s t j ɛ h t ɪ r
gangstéttirnar	k a ŋ k s t j ɛ h t ɪ t n a r
gangstéttum	k a ŋ k s t j ɛ h t ʏ m
gangstéttunum	k a ŋ k s t j ɛ h t ɔ n ʏ m
gangur	k a ŋ k ʏ r
gangurinn	k a ŋ k ʏ r ɪ n
garðablómi	k a r ð a p l ɔː u m ɪ
garðyrkjudeild	k a r ð ɪ r̥ c ʏ t ɛ j l t
garðyrkjuskólann	k a r ð ɪ r̥ c ʏ s k ɔː u l a n
garðyrkjustjóri	k a r ð ɪ r̥ c ʏ s t j ɔː u r ɪ
gasgreiningu	k aː s k r ɛ j n i ŋ k ʏ
gasmengun	k aː s m ɛ j ŋ k ʏ n
gauju	k œː j ʏ
gaujulundar	k œː j ʏ l ʏ n t a r
gauksson	k œ j k s ɔ n
gauksstaða	k œ j k s t a ð a
gaulandi	k œː j l a n t ɪ
gaumgæfni	k œ j m c a j p n ɪ
gaumgæfni	k œ j m c a j p n ɪ
gaupum	k œː j p ʏ m
gauta	k œː j t a
gautlönd	k œː j t l œ n t
geðshræring	c ɛ ð s r̥ a j r i ŋ k
geðveikislega	c ɛ ð v ɛ j c ɪ s t l ɛː ɣ a
gegndreypa	c ɛ k n t r ɛ j p a
gegnheil	c ɛ k n h ɛ j l
gegnheilum	c ɛ k n h ɛ j l ʏ m
gegnsteikt	c ɛ k s t ɛ j x t
gegnsær	c ɛ k s a j r
gegnumgangandi	c ɛ k n ʏ m k a ŋ k a n t ɪ
geig	c ɛː j ɣ
geilinni	c ɛː j l ɪ n ɪ
geimfar	c ɛ j m f a r
geimfarsins	c ɛ j m f a r̥ s ɪ n s
geimferðastofnunin	c ɛ j m f ɛ r ð a s t ɔ p n ʏ n ɪ n
geimferjur	c ɛ j m f ɛ r j ʏ r
geimflaugar	c ɛ j m f l œ j ɣ a r
geimflaugar	c ɛ j m f l œ j ɣ a r
geimsins	c ɛ j m s ɪ n s
geimstöð	c ɛ j m s t œ ð
geimveran	c ɛ j m v ɛ r a n
geimveru	c ɛ j m v ɛ r ʏ
geimverurnar	c ɛ j m v ɛ r ʏ t n a r
geirans	c ɛː j r a n s
geirarnir	c ɛː j r a t n ɪ r
geirfinna	c ɛ j r f ɪ n a
geirfinni	c ɛ j r f ɪ n ɪ
geirsnef	c ɛ j r̥ s n ɛ v
geislabelti	c ɛ j s t l a p ɛ l̥ t ɪ
geisladiskarnir	c ɛ j s t l a t ɪ s k a t n ɪ r
geisladiskinn	c ɛ j s t l a t ɪ s c ɪ n
geisladrifið	c ɛ j s t l a t r ɪː v ɪ ð
geisladýrð	c ɛ j s t l a t i r ð
geislafræðingarnir	c ɛ j s t l a f r aː j ð i ŋ k a t n ɪ r
geislafræðingarnir	c ɛ j s t l a f r aː j ð i ŋ k a t n ɪ r
geislaskammts	c ɛ j s t l a s k a m̥ t s
geislatækjum	c ɛ j s t l a tʰ a j c ʏ m
geislatækjum	c ɛ j s t l a tʰ a j c ʏ m
geislavirks	c ɛ j s t l a v ɪ r̥ k s
geisli	c ɛ j s t l ɪ
geislunartíma	c ɛ j s t l ʏ n a r tʰ iː m a
geitungaofsóknum	c ɛː j t u ŋ k a ɔ f s ɔ u h k n ʏ m
geitungaofsóknum	c ɛː j t u ŋ k a ɔ f s ɔ u h k n ʏ m
geldneytum	c ɛ l t n ɛ j t ʏ m
gengdarlausa	c ɛ j ŋ t a r l œː j s a
gengdarlausa	c ɛ j ŋ t a r l œː j s a
gengiskráningarvog	c ɛ j ɲ c ɪ s k r aː u n i ŋ k a r v ɔː ɣ
gengiskráningarvog	c ɛ j ɲ c ɪ s k r aː u n i ŋ k a r v ɔː ɣ
gengislækkunin	c ɛ j ɲ c ɪ s l a j h k ʏ n ɪ n
gengislækkunin	c ɛ j ɲ c ɪ s l a j h k ʏ n ɪ n
gengjur	c ɛ j ɲ c ʏ r
gerdeig	c ɛ r t ɛ j ɣ
gerilsneyðingar	c ɛː r ɪ l s t n ɛ j ð i ŋ k a r
gerjunarhæfni	c ɛ r j ʏ n a r h a j p n ɪ
gestagangur	c ɛ s t a k a ŋ k ʏ r
gestakór	c ɛ s t a kʰ ɔː u r
gestamóttaka	c ɛ s t a m ɔː u tʰ a k a
gestasöngvari	c ɛ s t a s œ j ŋ k v a r ɪ
getraun	c ɛː tʰ r œ j n
getraunaleikur	c ɛː tʰ r œ j n a l ɛː j k ʏ r
getraunaleikur	c ɛː tʰ r œ j n a l ɛː j k ʏ r
geymsluaðstæðna	c ɛ j m s t l ʏ a ð s t a j ð n a
geymsluaðstæðna	c ɛ j m s t l ʏ a ð s t a j ð n a
geysiskemmtilegum	c ɛː j s ɪ s c ɛ m̥ t ɪ l ɛ ɣ ʏ m
geysissvæðinu	c ɛː j s ɪ s v aː j ð ɪ n ʏ
geysissvæðinu	c ɛː j s ɪ s v aː j ð ɪ n ʏ
geysist	c ɛː j s ɪ s t
geysivinsælu	c ɛː j s ɪ v ɪ n s a j l ʏ
geysivinsælu	c ɛː j s ɪ v ɪ n s a j l ʏ
gigtsjúkdóma	c ɪ x t s j u k t ɔː u m a
gilhagi	c ɪː l̥ h a j ɪ
gissurardóttur	c ɪ s ʏ r a r t ɔ u h t ʏ r
gistiskálar	c ɪ s t ɪ s k aː u l a r
gjaldeyris	c a l t ɛ j r ɪ s
gjaldeyristekjunum	c a l t ɛ j r ɪ s tʰ ɛː c ɔ n ʏ m
gjábakkahraun	c aː u p a h k a r̥ œː j n
gjábakkahraun	c aː u p a h k a r̥ œː j n
gjávaðshylur	c aː u v a ð s h ɪː l ʏ r
gjóskugígarnir	c ɔ u s k ʏ k iː ɣ a r t n ɪ r
gjótum	c ɔː u tʰ ʏ m
gjótur	c ɔː u t ʏ r
gjúkadóttur	c uː k a t ɔ u h t ʏ r
gjörgæsludeilda	c œ r c a j s t l ʏ t ɛ j l t a
gjörgæsludeilda	c œ r c a j s t l ʏ t ɛ j l t a
glasafrjóvgun	k l aː s a f r j ɔ u v k ʏ n
glámu	k l aː u m ʏ
gleðihlátur	k l ɛː ð ɪ l̥ aː u t ʏ r
gleðisveit	k l ɛː ð ɪ s v ɛː j t
gleðisveitanna	k l ɛː ð ɪ s v ɛː j t a n a
gleraugna	k l ɛː r œ j k n a
gleypi	k l ɛː j p ɪ
gljámistill	k l j aː u m ɪ s t ɪ t l̥
gló	k l ɔː u
glósa	k l ɔː u s a
glósaður	k l ɔː u s a ð ʏ r
glærir	k l aː j r ɪ r
glærur	k l aː j r ʏ r
glærusýningagerð	k l aː j r ʏ s iː n i ŋ k a c ɛ r ð
glæsibókina	k l aː j s ɪ p ɔː u c ɪ n a
glæsibókina	k l aː j s ɪ p ɔː u c ɪ n a
glæsilegasti	k l aː j s ɪ l ɛː ɣ a s t ɪ
glæsileiki	k l aː j s ɪ l ɛː j c ɪ
glæsileiki	k l aː j s ɪ l ɛː j c ɪ
gnauða	k n œː j ð a
gná	k n aː u
Gnoðarvogi	k n ɔː ð a v ɔː j ɪ
goðahrauni	k ɔː ð a r̥ œː j n ɪ
goðasteins	k ɔː ð a s t ɛ j n s
golfleikarar	k ɔ l v l ɛ j k a r a r
golfmóti	k ɔ l v m ɔ u t ɪ
golfvallarhótelinu	k ɔ l v a t l a r̥ h ɔː u tʰ ɛ l ɪ n ʏ
gormælt	k ɔ r m a j l̥ t
Grafarvogi	k r aː v a r v ɔː j ɪ
grafarvoginum	k r aː v a r v ɔ j ɪ n ʏ m
grasalækningar	k r aː s a l a j h k n i ŋ k a r
grasbraut	k r aː s p r œ j t
grasdældarinnar	k r aː s t a j l t a r ɪ n a r
grasigróin	k r aː s ɪ k r ɔː u ɪ n
graskersættinni	k r aː s cʰ ɛ r̥ s a j h t ɪ n ɪ
grasrótarmenningu	k r aː s r ɔ u t a r m ɛ n i ŋ k ʏ
grautfúlt	k r œː j t f u l̥ t
grautinn	k r œː j t ɪ n
grágrýtishraunanna	k r aː u k r i t ɪ s r̥ œː j n a n a
grágrýtishraunanna	k r aː u k r i t ɪ s r̥ œː j n a n a
gráhegra	k r aː u h ɛ k r a
grásleppunet	k r aː u s t l ɛ h p ʏ n ɛː t
grásvepp	k r aː u s v ɛ h p
grátklökkri	k r aː u t kʰ l œ h k r ɪ
greiðslubyrðin	k r ɛ j ð s t l ʏ p ɪ r ð ɪ n
greiðslureglu	k r ɛ j ð s t l ʏ r ɛ k l ʏ
greiðsluskilmálar	k r ɛ j ð s t l ʏ s c ɪ l m au l a r
greinakaupa	k r ɛː j n a kʰ œː j p a
greinakaupa	k r ɛː j n a kʰ œː j p a
greinanna	k r ɛː j n a n a
greinargóða	k r ɛː j n a r k ɔː u ð a
greinargóða	k r ɛː j n a r k ɔː u ð a
greinarkorni	k r ɛː j n a r kʰ ɔ r t n ɪ
greinarmerkjum	k r ɛː j n a r m ɛ r̥ c ʏ m
greinarstúfsins	k r ɛː j n a r s t u f s ɪ n s
greindarlegt	k r ɛ j n t a r l ɛ x t
greinilegar	k r ɛː j n ɪ l ɛː ɣ a r
greiningargildi	k r ɛː j n i ŋ k a r c ɪ l t ɪ
greiningin	k r ɛː j n i ɲ c ɪ n
greinipunkti	k r ɛː j n ɪ pʰ u ŋ̊ t ɪ
grenjahnaus	k r ɛ n j a n̥ œː j s
greyptra	k r ɛ j f t r a
grillveisla	k r ɪ l v ɛ j s t l a
grímseyjarhrepps	k r i m s ɛ j a r̥ ɛ h p s
grjónum	k r j ɔː u n ʏ m
grjóthleðslu	k r j ɔː u t l̥ ɛ ð s t l ʏ
grjóthnullungum	k r j ɔː u t n̥ ʏ t l u ŋ k ʏ m
grjóthrun	k r j ɔː u t r̥ ʏ n
grjóthruns	k r j ɔː u t r̥ ʏ n s
gróðurblettur	k r ɔː u ð ʏ r̥ p l ɛ h t ʏ r
gróðurkortlagningu	k r ɔː u ð ʏ r̥ kʰ ɔ r̥ t l a k n i ŋ k ʏ
gróðurlausir	k r ɔː u ð ʏ r l œː j s ɪ r
gróðurlausir	k r ɔː u ð ʏ r l œː j s ɪ r
gróðurmagnið	k r ɔː u ð ʏ r m a k n ɪ ð
gróðursetning	k r ɔː u ð ʏ r̥ s ɛ h t n i ŋ k
gróðurvana	k r ɔː u ð ʏ r v a n a
gróffóðursins	k r ɔː u f ɔ u ð ʏ r̥ s ɪ n s
grófir	k r ɔː u v ɪ r
grófkristölluð	k r ɔː u v kʰ r ɪ s t œ t l ʏ ð
grófmalaður	k r ɔː u v m a l a ð ʏ r
grófofið	k r ɔː u f ɔ v ɪ ð
gróir	k r ɔː u ɪ r
gróttuvelli	k r ɔ u h t ʏ v ɛ t l ɪ
Grundartanga	k r ʏ n t a r t a ŋ k a
grundvallareining	k r ʏ n t v a t l a r ɛː j n i ŋ k
grunnfjárhæð	k r ʏ n f j au r h a j ð
grunnhreinsiefni	k r ʏ n r̥ ɛ j n s ɪ ɛ p n ɪ
grunnhreinsun	k r ʏ n r̥ ɛ j n s ʏ n
grunnmánaðarlaunum	k r ʏ n m au n a ð a r l œː j n ʏ m
grunnskólabraut	k r ʏ n s k ɔ u l a p r œː j t
grunnskólabraut	k r ʏ n s k ɔ u l a p r œː j t
grunnskólanefndar	k r ʏ n s k ɔ u l a n ɛ m t a r
grunnsævinu	k r ʏ n s a j v ɪ n ʏ
græddu	k r a j t ʏ
grænalóni	k r aː j n a l ɔː u n ɪ
grænalóni	k r aː j n a l ɔː u n ɪ
grænklæddu	k r a j ŋ kʰ l a j t ʏ
grænlandsdeildar	k r a j n l a n t s t ɛ j l t a r
grænlandsdeildar	k r a j n l a n t s t ɛ j l t a r
grænlenski	k r a j n l ɛ n s c ɪ
grænmetiskæfur	k r a j m ɛ t ɪ s c a j v ʏ r
gröfugaur	k r œː v ʏ k œː j r
guðdómlega	k v ʏ ð t ɔ u m l ɛː ɣ a
guðdómlegu	k v ʏ ð t ɔ u m l ɛː ɣ ʏ
guðleysingjar	k v ʏ ð l ɛ j s i ɲ c a r
guðsríkisbraut	k v ʏ ð s r i c ɪ s p r œː j t
gufubátsins	k ʏː v ʏ p aː u t s ɪ n s
gulgrænar	k ʏ l k r a j n a r
gulgrænn	k ʏ l k r a j t n̥
gulleit	k ʏ l ɛ j t
gulleitan	k ʏ l ɛ j t a n
gulleitu	k ʏ l ɛ j t ʏ
gulllóa	k ʏ l ɔ u a
gulrauður	k ʏ l r œ j ð ʏ r
gunnarshólma	k ʏ n a r s h ɔ u l m a
gúanófyrirtæki	k uː a n ɔ f ɪː r ɪ t ai c ɪ
gúmmíhandföngin	k u m i h a n t f œ ŋ k ɪ n
gvantanamó	k v a n t a n a m ɔː u
gyðingaofsóknir	c ɪː ð i ŋ k a ɔ f s ɔ u h k n ɪ r
göngulagi	k œy ŋ k ʏ l aː j ɪ
göngulagið	k œy ŋ k ʏ l aː j ɪ ð
göngulaginu	k œy ŋ k ʏ l aː j ɪ n ʏ
haffærisskírteini	h a f a j r ɪ s c i r̥ t ɛ j n ɪ
haffærisskírteini	h a f a j r ɪ s c i r̥ t ɛ j n ɪ
hafnarboltaknattleik	h a p n a r p ɔ l̥ t a kʰ n a h t l ɛ j k
hafnarbraut	h a p n a r p r œː j t
hafnarframkvæmdum	h a p n a r f r a m kʰ v a j m t ʏ m
hafnarsjóður	h a p n a r s j ɔː u ð ʏ r
hafnarvogin	h a p n a r v ɔ j ɪ n
hafrannsóknaráðsins	h a v r a n s ɔ u h k n a r au ð s ɪ n s
hafsteinsdóttur	h a f s t ɛ j n s t ɔ u h t ʏ r
hafsteinsdóttur	h a f s t ɛ j n s t ɔ u h t ʏ r
hafsvæðinu	h a f s v a j ð ɪ n ʏ
hagfræðigreinum	h a x f r a j ð ɪ k r ɛː j n ʏ m
hagfræðigreinum	h a x f r a j ð ɪ k r ɛː j n ʏ m
hagfræðiráðgjafarfyrirtækis	h a x f r a j ð ɪ r au ð c a v a r f ɪː r ɪ r tʰ aː j c ɪ s
hagfræðiskor	h a x f r a j ð ɪ s k ɔː r
hagi	h aː j ɪ
hagið	h aː j ɪ ð
haginn	h aː j ɪ n
hagkvæmasti	h a x kʰ v a j m a s t ɪ
haglastærð	h a k l a s t a j r ð
hagleiksmaður	h a ɣ l ɛ j k s m aː ð ʏ r
hagsmunahópa	h a x s m ʏ n a h ɔː u p a
hagstofustjóri	h a x s t ɔ v ʏ s t j ɔː u r ɪ
hagvaxtarskeið	h a ɣ v a k s t a r s c ɛː j ð
hamarháfi	h aː m a r h aː u v ɪ
hamarsbraut	h aː m a r̥ s p r œː j t
handahlaup	h a n t a l̥ œː j p
handfæri	h a n t f a j r ɪ
handhægu	h a n t h a j ɣ ʏ
handknattleiksdómararnir	h a n t kʰ n a h t l ɛ j k s t ɔː u m a r a t n ɪ r
handknattleiksdómararnir	h a n t kʰ n a h t l ɛ j k s t ɔː u m a r a t n ɪ r
handknattleiksráð	h a n t kʰ n a h t l ɛ j k s r aː u ð
handknattleiksráð	h a n t kʰ n a h t l ɛ j k s r aː u ð
handknattleikssambandinu	h a n t kʰ n a h t l ɛ j k s a m p a n t ɪ n ʏ
handlæknar	h a n t l a j h k n a r
handsprengjur	h a n t s p r ɛ j ɲ c ʏ r
handtæki	h a n tʰ a j c ɪ
handverkfæra	h a n t v ɛ r̥ k f a j r a
hantaveiruna	h a n̥ t a v ɛː j r ʏ n a
happdrætta	h a h p t r a j h t a
harmleikir	h a r m l ɛ j c ɪ r
harmonikkuleikari	h a r m ɔ n ɪ h k ʏ l ɛː j k a r ɪ
harmrænt	h a r m r a j n̥ t
hassneyslu	h a s t n ɛ j s t l ʏ
haug	h œː j ɣ
haugar	h œː j ɣ a r
haughúss	h œː j ɣ h u s
haugkjallara	h œː j ɣ c a t l a r a
haugunum	h œː j ɣ ɔ n ʏ m
haukavöllinn	h œː j k a v œ t l ɪ n
haukdal	h œː j k t a l
haustferð	h œ j s t f ɛ r ð
haustfífillinn	h œ j s t f i v ɪ t l ɪ n
haustfrí	h œ j s t f r iː
haustfundi	h œ j s t f ʏ n t ɪ
haustfundur	h œ j s t f ʏ n t ʏ r
haustgulri	h œ j s t k ʏ l r ɪ
haustlitir	h œ j s t l ɪː t ɪ r
haustmótið	h œ j s t m ɔ u t ɪ ð
haustmótið	h œ j s t m ɔ u t ɪ ð
haustmyrkurs	h œ j s t m ɪ r̥ k ʏ r̥ s
haustprófinu	h œ j s t pʰ r ɔ u ɪ n ʏ
haustprófinu	h œ j s t pʰ r ɔ u ɪ n ʏ
haustrall	h œ j s t r a l
haustskrúða	h œ j s t s k r u ð a
haustveður	h œ j s t v ɛ ð ʏ r
hausum	h œː j s ʏ m
heilabilað	h ɛː j l a p ɪː l a ð
heilablæðingar	h ɛː j l a p l a j ð i ŋ k a r
heilablæðingar	h ɛː j l a p l a j ð i ŋ k a r
heilagri	h ɛː j l a ɣ r ɪ
heilahimnur	h ɛː j l a h ɪ m n ʏ r
heilahrörnun	h ɛː j l a r̥ œ r t n ʏ n
heilarar	h ɛː j l a r a r
heilasýni	h ɛː j l a s iː n ɪ
heilavefur	h ɛː j l a v ɛː v ʏ r
heilbrigðisfulltrúa	h ɛ j l p r ɪ ɣ ð ɪ s f ʏ t l̥ tʰ r u a
heilbrigðishópi	h ɛ j l p r ɪ ɣ ð ɪ s h ɔː u p ɪ
heilbrigðishópi	h ɛ j l p r ɪ ɣ ð ɪ s h ɔː u p ɪ
heilbrigðishugtökum	h ɛ j l p r ɪ ɣ ð ɪ s h ʏ x tʰ œ k ʏ m
heilbrigðisráðherrann	h ɛ j l p r ɪ ɣ ð ɪ s r aː u ð h ɛ r a n
heilbrigðisráðherrann	h ɛ j l p r ɪ ɣ ð ɪ s r aː u ð h ɛ r a n
heilbrigðisskor	h ɛ j l p r ɪ ɣ ð ɪ s k ɔː r
heildarfjárfesting	h ɛ j l t a r̥ f j au r̥ f ɛ s t i ŋ k
heildarframlaga	h ɛ j l t a r̥ f r a m l a ɣ a
heildarheiti	h ɛ j l t a r̥ h ɛː j t ɪ
heildarhlutfall	h ɛ j l t a r̥ l̥ ʏː t f a t l̥
heildarkaupverð	h ɛ j l t a r̥ kʰ œː j p v ɛ r ð
heildarkaupverð	h ɛ j l t a r̥ kʰ œː j p v ɛ r ð
heildarlaunum	h ɛ j l t a r l œː j n ʏ m
heildarlaunum	h ɛ j l t a r l œː j n ʏ m
heildarmagn	h ɛ j l t a r m a k n̥
heildarmyndin	h ɛ j l t a r m ɪ n t ɪ n
heildarpakkann	h ɛ j l t a r̥ pʰ a h k a n
heildarrennsli	h ɛ j l t a r ɛ n s t l ɪ
heildarskipan	h ɛ j l t a r̥ s c ɪː p a n
heildarskipulag	h ɛ j l t a r̥ s c ɪː p ʏ l a ɣ
heildarslátrun	h ɛ j l t a r̥ s t l aː u t r ʏ n
heildarslátrun	h ɛ j l t a r̥ s t l aː u t r ʏ n
heildartextar	h ɛ j l t a r̥ t ɛ k s t a r
heildsölufyrirtækinu	h ɛ j l t s œ l ʏ f ɪː r ɪ r̥ tʰ a j c ɪ n ʏ
heildsölufyrirtækinu	h ɛ j l t s œ l ʏ f ɪː r ɪ r̥ tʰ a j c ɪ n ʏ
heilleiki	h ɛ j l ɛ j c ɪ
heilmikinn	h ɛ j l m ɪ c ɪ n
heilmöskvi	h ɛ j l m œ s k v ɪ
heilsubúðunum	h ɛ j l s ʏ p uː ð ɔ n ʏ m
heilsubæjar	h ɛ j l s ʏ p a j a r
heilsubæjar	h ɛ j l s ʏ p a j a r
heilsubætandi	h ɛ j l s ʏ p a j t a n t ɪ
heilsubætandi	h ɛ j l s ʏ p a j t a n t ɪ
heilsufarssögu	h ɛ j l s ʏ f a r̥ s œː ɣ ʏ
heilsufarsupplýsingum	h ɛ j l s ʏ f a r̥ s ʏ h p l i s i ŋ k ʏ m
heilsugóður	h ɛ j l s ʏ k ɔː u ð ʏ r
heilsugóður	h ɛ j l s ʏ k ɔː u ð ʏ r
heilsugæslan	h ɛ j l s ʏ c a j s t l a n
heilsugæslan	h ɛ j l s ʏ c a j s t l a n
heilsugæsluhjúkrunarfræðingum	h ɛ j l s ʏ c a j s t l ʏ ç uː k r ʏ n a r f r a j ð i ŋ k ʏ m
heilsugæsluhjúkrunarfræðingum	h ɛ j l s ʏ c a j s t l ʏ ç uː k r ʏ n a r f r a j ð i ŋ k ʏ m
heilsugæslustöðina	h ɛ j l s ʏ c a j s t l ʏ s t œː ð ɪ n a
heilsugæslustöðina	h ɛ j l s ʏ c a j s t l ʏ s t œː ð ɪ n a
heilsugæslustöðvanna	h ɛ j l s ʏ c a j s t l ʏ s t œ ð v a n a
heilsugæslustöðvanna	h ɛ j l s ʏ c a j s t l ʏ s t œ ð v a n a
heilsuhorninu	h ɛ j l s ʏ h ɔ t n ɪ n ʏ
heilsuhúsinu	h ɛ j l s ʏ h uː s ɪ n ʏ
heilsuhælis	h ɛ j l s ʏ h aː j l ɪ s
heilsuhælis	h ɛ j l s ʏ h aː j l ɪ s
heilsum	h ɛ j l s ʏ m
heilsuræktarhandbókina	h ɛ j l s ʏ r a j x t a r h a n t p ɔ u c ɪ n a
heilsuræktarhandbókina	h ɛ j l s ʏ r a j x t a r h a n t p ɔ u c ɪ n a
heilsuræktarhandbókina	h ɛ j l s ʏ r a j x t a r h a n t p ɔ u c ɪ n a
heilsuræktarstöðvum	h ɛ j l s ʏ r a j x t a r s t œ ð v ʏ m
heilsuræktarstöðvum	h ɛ j l s ʏ r a j x t a r s t œ ð v ʏ m
heilsusamlegan	h ɛ j l s ʏ s a m l ɛ ɣ a n
heilsustöðvunum	h ɛ j l s ʏ s t œ ð v ɔ n ʏ m
heimabrúks	h ɛː j m a p r u k s
heimabæjar	h ɛː j m a p a j a r
heimabæjar	h ɛː j m a p a j a r
heimagangur	h eiː m a k a ŋ k ʏ r
heimahjúkrunar	h ɛː j m a ç uː k r ʏ n a r
heimahöfn	h ɛː j m a h œ p n̥
heimakomusýktum	h ɛː j m a kʰ ɔː m ʏ s i x t ʏ m
heimakrókum	h ɛː j m a kʰ r ɔː u k ʏ m
heimakrókum	h ɛː j m a kʰ r ɔː u k ʏ m
heimalyklar	h ɛː j m a l ɪ h k l a r
heimangengt	h eiː m a n c ei ŋ̊ t
heimangengt	h eiː m a n c ei ŋ t
heimanrekinna	h ɛː j m a n r ɛː c ɪ n a
heimasíðna	h ɛː j m a s i ð n a
heimastjórnarsvæðinu	h ɛː j m a s t j ɔ u r t n a r s v aː j ð ɪ n ʏ
heimastjórnarsvæðinu	h ɛː j m a s t j ɔ u r t n a r s v aː j ð ɪ n ʏ
heimastjórnarsvæðinu	h ɛː j m a s t j ɔ u r t n a r s v aː j ð ɪ n ʏ
heimatak	h ɛː j m a tʰ aː k
heimatökin	h ɛː j m a tʰ œː c ɪ n
heimaverkefnið	h ɛː j m a v ɛ r̥ k ɛ p n ɪ ð
heimavöllurinn	h ɛː j m a v œ t l ʏ r ɪ n
heimdallur	h ɛ j m t a t l ʏ r
heimfluginu	h ɛ j m f l ʏ j ɪ n ʏ
heimfluginu	h ɛ j m f l ʏ j ɪ n ʏ
heimildakönnun	h ɛː j m ɪ l t a kʰ œ n ʏ n
heimildarbeiðnum	h ɛː j m ɪ l t a r p ɛ j ð n ʏ m
heimildarkvikmynd	h ɛː j m ɪ l t a kʰ v ɪ k m ɪ n t
heimildarmaður	h ɛː j m ɪ l t a r m aː ð ʏ r
heimildarmynda	h ɛː j m ɪ l t a r m ɪ n t a
heimilisfang	h eiː m ɪ l ɪ s f a ŋ k
heimilisfangi	h eiː m ɪ l ɪ s f a ɲ c ɪ
heimilisfólksins	h ɛː j m ɪ l ɪ s f ɔ u l̥ k s ɪ n s
heimilisfólksins	h ɛː j m ɪ l ɪ s f ɔ u l̥ k s ɪ n s
heimilisfræðikennslu	h ɛː j m ɪ l ɪ s f r aː j ð ɪ cʰ ɛ n s t l ʏ
heimilisfræðikennslu	h ɛː j m ɪ l ɪ s f r aː j ð ɪ cʰ ɛ n s t l ʏ
heimilisofbeldis	h ɛː j m ɪ l ɪ s ɔ v p ɛ l t ɪ s
heimilistæki	h ɛː j m ɪ l ɪ s tʰ a j c ɪ
heimilistæki	h ɛː j m ɪ l ɪ s tʰ a j c ɪ
heimilistölva	h ɛː j m ɪ l ɪ s t œ l v a
heimilskatta	h ɛː j m ɪ l s k a h t a
heimisdóttur	h ɛː j m ɪ s t ɔ u h t ʏ r
heimisdóttur	h ɛː j m ɪ s t ɔ u h t ʏ r
heimsambandið	h ɛ j m s a m p a n t ɪ ð
heimsbókmenntanna	h ɛ j m s p ɔ u k m ɛ n̥ t a n a
heimsbókmenntanna	h ɛ j m s p ɔ u k m ɛ n̥ t a n a
heimsbörnin	h ɛ j m s p œ r t n ɪ n
heimsfengs	h ɛ j m s f ɛ j ŋ s
heimsferðir	h ɛ j m s f ɛ r ð ɪ r
heimsforeldri	h ɛ j m s f ɔ r ɛ l t r ɪ
heimsforseti	h ɛ j m s f ɔ r̥ s ɛ t ɪ
heimskauti	h ɛ j m s k œ j t ɪ
heimskauti	h ɛ j m s k œ j t ɪ
heimskautsbaug	h ɛ j m s k œ j t s p œː j ɣ
heimskautsbaug	h ɛ j m s k œ j t s p œː j ɣ
heimskautsbaugurinn	h ɛ j m s k œ j t s p œː j ɣ ʏ r ɪ n
heimskautsbaugurinn	h ɛ j m s k œ j t s p œː j ɣ ʏ r ɪ n
heimskringla	h ɛ j m s kʰ r i ŋ l a
heimskum	h ɛ j m s k ʏ m
heimsmeistaraeinvígi	h ɛ j m s m ɛ j s t a r a ɛ j n v i j ɪ
heimsmeistarakeppnin	h ɛ j m s m ɛ j s t a r a cʰ ɛ h p n ɪ n
heimspekihefðar	h ɛ j m s p ɛ c ɪ h ɛ v ð a r
heimspekilegi	h ɛ j m s p ɛ c ɪ l ɛ j ɪ
heimspekin	h ɛ j m s p ɛ c ɪ n
heimspekiskorinni	h ɛ j m s p ɛ c ɪ s k ɔː r ɪ n ɪ
heimsskipan	h ɛ j m s c ɪ p a n
heimtaugar	h ɛ j m tʰ œ j ɣ a r
heimtaugar	h ɛ j m tʰ œ j ɣ a r
heimtaugargjald	h ɛ j m̥ t œ j ɣ a r c a l t
heimtaugargjald	h ɛ j m̥ t œ j ɣ a r c a l t
heitastur	h ɛː j t a s t ʏ r
heitnir	h ɛ j h t n ɪ r
heitreykt	h ɛː j tʰ r ɛ j x t
heitustu	h ɛː j t ʏ s t ʏ
heklugjá	h ɛ h k l ʏ c aː u
heklunálar	h ɛ h k l ʏ n aː u l a r
hektó	h ɛ x t ɔ u
helgafellsbraut	h ɛ l k a f ɛ l s p r œː j t
helgisöngvar	h ɛ l c ɪ s œ j ŋ k v a r
heljargjá	h ɛ l j a r c aː u
heljargreipum	h ɛ l j a r k r ɛː j p ʏ m
hellisheiðarþoku	h ɛ t l ɪ s h ɛ j ð a r θ ɔː k ʏ
hellnahóll	h ɛ t l n a h ɔ u t l̥
hengibjörk	h ɛ j ɲ c ɪ p j œ r̥ k
hengiflug	h ɛ j ɲ c ɪ f l ʏː ɣ
herbergiseigandans	h ɛ r p ɛ r c ɪ s ɛː j ɣ a n t a n s
herforingjastjórnar	h ɛ r̥ f ɔ r i ɲ c a s t j ɔ u r t n a r
herranæturleikritið	h ɛ r a n aː j t ʏ r l ɛː j k r ɪ t ɪ ð
herranæturleikritið	h ɛ r a n aː j t ʏ r l ɛː j k r ɪ t ɪ ð
hersteinsdóttir	h ɛ r̥ s t ɛ j n s t ɔ u h t ɪ r
hersteinsdóttir	h ɛ r̥ s t ɛ j n s t ɔ u h t ɪ r
hetjudáðina	h ɛː t j ʏ t aː u ð ɪ n a
heygafflar	h ɛː j k a f l a r
heyknosara	h ɛː j h kʰ n ɔ s a r a
heymaur	h ɛː j m œ j r
heymaur	h ɛː j m œ j r
heyrnarlausa	h ɛ j r t n a r l œː j s a
heyrnarlausa	h ɛ j r t n a r l œː j s a
heyrnarskertir	h ɛ j r t n a r̥ s c ɛ r̥ t ɪ r
heyrnartólin	h ɛ j r t n a r tʰ ɔː u l ɪ n
heyrnartólin	h ɛ j r t n a r tʰ ɔː u l ɪ n
heysins	h ɛː j s ɪ n s
heyvinnuna	h ɛː j v ɪ n ʏ n a
hiklausan	h ɪː k l œ j s a n
hiklaust	h ɪː k l au s t
hildarleik	h ɪ l t a r l ɛː j k
hilmarsdóttur	h ɪ l m a r̥ s t ɔ u h t ʏ r
himingeimsins	h ɪː m i n c ɛ j m s ɪ n s
himinhrópandi	h ɪː m ɪ n r̥ ɔː u p a n t ɪ
himnasæld	h ɪ m n a s a j l t
himnasælu	h ɪ m n a s aː j l ʏ
hindrunarlausa	h ɪ n t r ʏ n a r l œː j s a
hitabreytingarnar	h ɪː t a p r ɛː j t i ŋ k a t n a r
hitaeiningarnar	h ɪː t a ɛ j n i ŋ k a t n a r
hitagildi	h ɪː t a c ɪ l t ɪ
hitahækkunina	h ɪː t a h a j h k ʏ n ɪ n a
hitalaus	h ɪː t a l œː j s
hitasamhengi	h ɪː t a s aː m h ɛ j ɲ c ɪ
hitaskápum	h ɪː t a s k aː u p ʏ m
hitastjórnun	h ɪː t a s t j ɔ u r t n ʏ n
hitaveitur	h ɪː t a v ɛː j t ʏ r
hitlersæsingurinn	h ɪ h t l ɛ r̥ s a j s i ŋ k ʏ r ɪ n
hitunartækjum	h ɪː t ʏ n a r tʰ aː j c ʏ m
hjaltadóttur	ç a l̥ t a t ɔ u h t ʏ r
hjartahrein	ç a r̥ t a r̥ ɛː j n
hjálparleit	ç au l̥ p a r l ɛː j t
hjálparsveit	ç au l̥ p a r̥ s v ɛː j t
hjálparsveitastarf	ç au l̥ p a r̥ s v ɛ j t a s t a r v
hjálparsveitin	ç au l̥ p a r̥ s v ɛ j t ɪ n
hjálparsveitina	ç au l̥ p a r̥ s v ɛ j t ɪ n a
hjólaferð	ç ɔː u l a f ɛ r ð
hjólafólki	ç ɔː u l a f ɔ u l̥ c ɪ
hjólalegur	ç ɔː u l a l ɛː ɣ ʏ r
hjólaleið	ç ɔː u l a l ɛː j ð
hjólaleið	ç ɔː u l a l ɛː j ð
hjólastellið	ç ɔː u l a s t ɛ l ɪ ð
hjólastillingarbúnað	ç ɔː u l a s t ɪ t l i ŋ k a r p uː n a ð
hjólhestsins	ç ɔː u l h ɛ s t s ɪ n s
hjólkróna	ç ɔ u l kʰ r ɔ u n a
hjólreiða	ç ɔ u l r ɛ j ð a
hjólreiða	ç ɔ u l r ɛ j ð a
hjólreiðamanna	ç ɔ u l r ɛ j ð a m a n a
hjólreiðamanna	ç ɔ u l r ɛ j ð a m a n a
hjólreiðamenn	ç ɔ u l r ɛ j ð a m ɛ n
hjólreiðamenn	ç ɔ u l r ɛ j ð a m ɛ n
hjóls	ç ɔ u l s
hjólsins	ç ɔ u l s ɪ n s
hjúkrunarfræðideild	ç uː k r ʏ n a r f r a j ð ɪ t ɛ j l t
hjúkrunarfræðideild	ç uː k r ʏ n a r f r a j ð ɪ t ɛ j l t
hjúkrunarfræðing	ç uː k r ʏ n a r f r a j ð i ŋ k
hjúkrunarfræðings	ç uː k r ʏ n a r f r a j ð i ŋ k s
hjúkrunargreinar	ç uː k r ʏ n a r k r ɛː j n a r
hjúkrunargreiningu	ç uː k r ʏ n a r k r ɛː j n i ŋ k ʏ
hjúkrunarráð	ç uː k r ʏ n a r aː u ð
hjörleifsdóttir	ç œ r l ɛ j f s t ɔ u h t ɪ r
hjörleifsdóttir	ç œ r l ɛ j f s t ɔ u h t ɪ r
hlaupabólu	l̥ œː j p a p ɔː u l ʏ
hlaupabólu	l̥ œː j p a p ɔː u l ʏ
hlaupabrautir	l̥ œː j p a p r œː j t ɪ r
hlaupara	l̥ œː j p a r a
hlaupmiðun	l̥ œː j p m ɪ ð ʏ n
hleðslutengill	l̥ ɛ ð s t l ʏ tʰ ɛ j ɲ c ɪ t l̥
hleifinn	l̥ ɛː j v ɪ n
hleina	l̥ ɛː j n a
hleyp	l̥ ɛː j p
hliðarhreyfingar	l̥ ɪː ð a r̥ ɛː j v i ŋ k a r
hliðarhreyfingum	l̥ ɪː ð a r̥ ɛː j v i ŋ k ʏ m
hliðrænir	l̥ ɪ ð r a j n ɪ r
hliðstæðar	l̥ ɪ ð s t a j ð a r
hlífalausir	l̥ iː f a l œː j s ɪ r
hljóðeinangrunarplötum	l̥ j ɔː u ð ɛ j n au ŋ k r ʏ n a r pʰ l œː t ʏ m
hljóðeinangrunarplötum	l̥ j ɔː u ð ɛ j n au ŋ k r ʏ n a r pʰ l œː t ʏ m
hljóðhimnurnar	l̥ j ɔː u ð h ɪ m n ʏ t n a r
hljóðrits	l̥ j ɔ u ð r ɪ t s
hljóðvinnsluforrits	l̥ j ɔ u ð v ɪ n s t l ʏ f ɔ r ɪ t s
hljómblæbrigða	l̥ j ɔ u m p l a j p r ɪ ɣ ð a
hljómblæbrigða	l̥ j ɔ u m p l a j p r ɪ ɣ ð a
hljómbönd	l̥ j ɔ u m p œ n t
hljómleikaplata	l̥ j ɔ u m l ɛ j k a p l aː t a
hljómleikaplata	l̥ j ɔ u m l ɛ j k a p l aː t a
hljómlist	l̥ j ɔ u m l ɪ s t
hljómlistarmaður	l̥ j ɔ u m l ɪ s t a r m aː ð ʏ r
hljómskífa	l̥ j ɔ u m s c i v a
hljómsveitarmeðlimir	l̥ j ɔ u m s v ɛ j t a r m ɛ ð l ɪ m ɪ r
hljómsveitarmeðlimir	l̥ j ɔ u m s v ɛ j t a r m ɛ ð l ɪ m ɪ r
hljómsveitastjóri	l̥ j ɔ u m s v ɛ j t a s t j ɔː u r ɪ
hljómsveitastjóri	l̥ j ɔ u m s v ɛ j t a s t j ɔː u r ɪ
hljómsveitavænasta	l̥ j ɔ u m s v ɛ j t a v aː j n a s t a
hljómsveitavænasta	l̥ j ɔ u m s v ɛ j t a v aː j n a s t a
hljómsveitavænasta	l̥ j ɔ u m s v ɛ j t a v aː j n a s t a
hljótist	l̥ j ɔː u t ɪ s t
hlunnindaráðunautur	l̥ ʏ n ɪ n t a r aː u ð ʏ n œː j t ʏ r
hlunnindaráðunautur	l̥ ʏ n ɪ n t a r aː u ð ʏ n œː j t ʏ r
hlustunaræfing	l̥ ʏ s t ʏ n a r aː j f i ŋ k
hlutdrægni	l̥ ʏː t r a j k n ɪ
hlutfallagóð	l̥ ʏː t f a t l a k ɔː u ð
hlykkjabraut	l̥ ɪ h c a p r œː j t
hlöllabátur	l̥ œ l a p aː u t ʏ r
hnattrænu	n̥ a h t r a j n ʏ
hnattvædd	n̥ a h t v a j t
hnaus	n̥ œː j s
hnausastrengnum	n̥ œː j s a s t r ɛ j ŋ n ʏ m
hnausastrengnum	n̥ œː j s a s t r ɛ j ŋ n ʏ m
hneigja	n̥ ɛː j a
hneigjum	n̥ ɛː j ʏ m
hneykslar	n̥ ɛ j k s t l a r
hnébeygjulyftu	n̥ j ɛː p ɛ j ʏ l ɪ f t ʏ
hnitunartækis	n̥ ɪː t ʏ n a r tʰ a j c ɪ s
hnullungagrjóti	n̥ ʏ t l u ŋ k a k r j ɔː u t ɪ
hoftóft	h ɔ f t ɔ u h t
holtaskóli	h ɔ l̥ t a s k ɔː u l ɪ
hormóna	h ɔ r m ɔ u n a
hormónaplástur	h ɔ r m ɔ u n a p l au s t ʏ r
hormónarugls	h ɔ r m ɔ u n a r ʏ k l s
hormónastafurinn	h ɔ r m ɔ u n a s t aː v ʏ r ɪ n
hormónin	h ɔ r m ɔ u n ɪ n
hormónum	h ɔ r m ɔ u n ʏ m
hraðbanka	r̥ a ð p a ŋ̊ k a
hraðskákmeistara	r̥ a ð s k au k m ɛ j s t a r a
hraðskreiður	r̥ a ð s k r ɛ j ð ʏ r
hrauna	r̥ œː j n a
hraunbollum	r̥ œ j n p ɔ t l ʏ m
hraunbúar	r̥ œ j n p u a r
hraunfjörð	r̥ œ j n f j œ r ð
hraungrýti	r̥ œ j ŋ k r i t ɪ
hraunhóli	r̥ œː j n h ɔ u l ɪ
hraunhóli	r̥ œː j n h ɔ u l ɪ
hraunhreppi	r̥ œː j n r̥ ɛ h p ɪ
hraunhvolf	r̥ œ j ŋ̊ kʰ v ɔ l v
hraunkælingu	r̥ œ j ŋ̊ cʰ aː j l ɪ ŋ k ʏ
hraunkælingu	r̥ œ j ŋ̊ cʰ aː j l ɪ ŋ k ʏ
hraunsási	r̥ œ j n s au s ɪ
hraunsins	r̥ œ j n s ɪ n s
hraunsprunga	r̥ œ j n s p r u ŋ k a
hraunsúlur	r̥ œː j n s u l ʏ r
hrár	r̥ aː u r
hreiðarsdóttir	r̥ ɛː j ð a r̥ s t ɔ u h t ɪ r
hreiðarsdóttir	r̥ ɛː j ð a r̥ s t ɔ u h t ɪ r
hreiðarssonar	r̥ ɛː j ð a r̥ s ɔː n a r
hreiðurgerð	r̥ ɛː j ð ʏ r c ɛ r ð
hreinlegt	r̥ ɛ j n l ɛ x t
hreinleiki	r̥ ɛ j n l ɛ j c ɪ
hreinlætisiðnað	r̥ ɛ j n l a j t ɪ s ɪ ð n a ð
hreinlætisiðnað	r̥ ɛ j n l a j t ɪ s ɪ ð n a ð
hreinlætisnámskeið	r̥ ɛ j n l a j t ɪ s t n au m s c ɛ j ð
hreinlætisnámskeið	r̥ ɛ j n l a j t ɪ s t n au m s c ɛ j ð
hreinlætisumræður	r̥ ɛ j n l a j t ɪ s ʏ m r a j ð ʏ r
hreinlætisumræður	r̥ ɛ j n l a j t ɪ s ʏ m r a j ð ʏ r
hreinræktaðri	r̥ ɛ j n r a j x t a ð r ɪ
hreinræktaðri	r̥ ɛ j n r a j x t a ð r ɪ
hreinsiefni	r̥ ɛ j n s ɪ ɛ p n ɪ
hreinsiklúta	r̥ ɛ j n s ɪ kʰ l uː t a
hreinsilögur	r̥ ɛ j n s ɪ l œː ɣ ʏ r
hreinsimjólkinni	r̥ ɛ j n s ɪ m j ɔ u l̥ c ɪ n ɪ
hreinsimjólkinni	r̥ ɛ j n s ɪ m j ɔ u l̥ c ɪ n ɪ
hreinsitækni	r̥ ɛ j n s ɪ tʰ a j h k n ɪ
hreinsitækni	r̥ ɛ j n s ɪ tʰ a j h k n ɪ
hreinsiútbúnaður	r̥ ɛ j n s ɪ uː t p u n a ð ʏ r
hreinsivökvi	r̥ ɛ j n s ɪ v œː k v ɪ
hrekkjótt	r̥ ɛ h c ɔ u h t
hrekklaus	r̥ ɛ h k l œ j s
hreyfanlegum	r̥ ɛː j v a n l ɛː ɣ ʏ m
hreyfanleika	r̥ ɛː j v a n l ɛː j k a
hreyfðar	r̥ ɛ j v ð a r
hreyfiafli	r̥ ɛː j v ɪ a p l ɪ
hreyfilandi	r̥ ɛː j v ɪ l a n t ɪ
hreyfivinna	r̥ ɛː j v ɪ v ɪ n a
hreyfiþroskann	r̥ ɛː j v ɪ θ r ɔ s k a n
hríseyjar	r̥ iː s ɛ j a r
hrísgrjónadeigi	r̥ iː s k r j ɔ u n a t ɛː j ɪ
hrísgrjónadeigi	r̥ iː s k r j ɔ u n a t ɛː j ɪ
hrísgrjónaköggli	r̥ iː s k r j ɔ u n a kʰ œ k l ɪ
hrísgrjónastallar	r̥ iː s k r j ɔ u n a s t a t l a r
hrísgrjónaökrum	r̥ iː s k r j ɔ u n a œː k r ʏ m
hrísmjölsgraut	r̥ iː s m j œ l s k r œː j t
hrossagauk	r̥ ɔ s a k œː j k
hróki	r̥ ɔː u c ɪ
hróksins	r̥ ɔ u k s ɪ n s
hrókurinn	r̥ ɔː u k ʏ r ɪ n
hrópgjarnir	r̥ ɔ u pʰ c a t n ɪ r
hrópið	r̥ ɔː u p ɪ ð
hrútleiðinlegu	r̥ uː t l ɛ j ð ɪ n l ɛː ɣ ʏ
hryggbeinið	r̥ ɪ k p ɛ j n ɪ ð
hrynleysu	r̥ i n l ɛ j s ʏ
hrærivélarnar	r̥ aː j r ɪ v j ɛː l a t n a r
hrökkbrauð	r̥ œ h k p r œ j ð
hugbúnaðarfyrirtækisins	h ʏ ɣ p u n a ð a r f ɪː r ɪ r tʰ aː j c ɪ s ɪ n s
hugdeigir	h ʏ ɣ t ɛ j ɪ r
hugheilum	h ʏː ɣ h ɛ j l ʏ m
hugleiðsla	h ʏ ɣ l ɛ j ð s t l a
hugmyndafræðileg	h ʏ ɣ m ɪ n t a f r a j ð ɪ l ɛ ɣ
hugmyndafræðilegar	h ʏ ɣ m ɪ n t a f r a j ð ɪ l ɛ ɣ a r
hugmyndaheim	h ʏ ɣ m ɪ n t a h ɛː j m
hugræktar	h ʏ ɣ r a j x t a r
hugsjónabróður	h ʏ x s j ɔ u n a p r ɔː u ð ʏ r
hugsjónarmaður	h ʏ x s j ɔ u n a r m aː ð ʏ r
hugskeyti	h ʏ x s c ɛ j t ɪ
hulduslóð	h ʏ l t ʏ s t l ɔ u ð
hundaeigandi	h ʏ n t a ɛː j ɣ a n t ɪ
hundaeigendur	h ʏ n t a ɛː j ɣ ɛ n t ʏ r
hundaeign	h ʏ n t a ɛ j k n̥
hundagöngunni	h ʏ n t a k œ j ŋ k ʏ n ɪ
hundahandbókin	h ʏ n t a h a n t p ɔ u c ɪ n
hundaskólann	h ʏ n t a s k ɔː u l a n
hundaskólinn	h ʏ n t a s k ɔː u l ɪ n
hundpúkaleiðinlegir	h ʏ n t pʰ uː k a l ɛː j ð ɪ n l ɛ j ɪ r
hundshausar	h ʏ n t s h œ j s a r
hungursneyðin	h u ŋ k ʏ r̥ s t n ɛː j ð ɪ n
hvalaskoðunarbátur	kʰ v aː l a s k ɔː ð ʏ n a r p aː u t ʏ r
hvaleyrarholtsvelli	kʰ v aː l ɛ j r a r h ɔ l̥ t s v ɛ t l ɪ
hvaleyri	kʰ v a l ɛ j r ɪ
hvarfslóð	kʰ v a r v s t l ɔ u ð
hveitikímsolía	kʰ v ɛː j t ɪ cʰ i m s ɔː l i j a
hveitis	kʰ v ɛ j t ɪ s
hveragerðisbæjar	kʰ v ɛː r a c ɛ r ð ɪ s p aː j a r
hverfaleiðir	kʰ v ɛ r v a l ɛː j ð ɪ r
hverfisráð	kʰ v ɛ r v ɪ s r aː u ð
hversdagsleika	kʰ v ɛ r̥ s t a k s t l ɛ j k a
hversdagsleiknum	kʰ v ɛ r̥ s t a k s t l ɛ j h k n ʏ m
hvítfreknótt	kʰ v iː t f r ɛ h k n ɔ u h t
hvítlauksafurðin	kʰ v iː t l œ j k s aː v ʏ r ð ɪ n
hvítlauksrifin	kʰ v iː t l œ j k s r ɪː v ɪ n
hvítlaukur	kʰ v iː t l œ j k ʏ r
hvolpafóður	kʰ v ɔ l̥ p a f ɔː u ð ʏ r
höfðalagið	h œ v ð a l a j ɪ ð
ilbreið	ɪ l p r ɛ j ð
illræmdi	i t l̥ r a j m t ɪ
illræmdu	i t l̥ r a j m t ʏ
illviðráðanlegri	i t l̥ v ɪ ð r aː u ð a n l ɛ ɣ r ɪ
impressjónismi	ɪ m p r ɛ s j ɔ u n ɪ s m ɪ
indíanapólis	ɪ n t i j a n a pʰ ɔː u l ɪ s
ingólfsbrunn	i ŋ k ɔ u l s p r ʏ n
ingvadóttir	i ŋ k v a t ɔ u h t ɪ r
innangengt	ɪ n a n c ei ŋ̊ t
innangengt	ɪ n a n c ei ŋ t
innangengt	ɪ n a n c ɛ ŋ̊ t
innangengt	ɪ n a n c ɛ ŋ̊ t
innanlandsflugi	ɪ n a n l a n t s f l ʏː j ɪ
innanlandsflugið	ɪ n a n l a n t s f l ʏː j ɪ ð
innanlandsfluginu	ɪ n a n l a n t s f l ʏː j ɪ n ʏ
innbæjarins	ɪ m p a j a r ɪ n s
innfærslu	ɪ n f a j r̥ s t l ʏ
inngönguhurðir	ɪ ŋ k œ j ŋ k ʏ h ʏ r ð ɪ r
innheimti	ɪ n h ɛ j m̥ t ɪ
innheimtuna	ɪ n h ɛ j m̥ t ʏ n a
innherjaupplýsingum	ɪ n h ɛ r j a ʏ h p l i s i ŋ k ʏ m
innihaldslausra	ɪ n ɪ h a l t s t l œː j s r a
innileik	ɪ n ɪ l ɛ i k
innileika	ɪ n ɪ l ɛ i k a
innisundlaug	ɪ n ɪ s ʏ n t l œ j ɣ
innkaup	ɪ ŋ k au p
innkaupa	ɪ ŋ k au p a
innkaupalistar	ɪ ŋ kʰ œ j p a l ɪ s t a r
innkaupastjóri	ɪ ŋ k au p a s t j ouː r ɪ
innkaupastjórnun	ɪ ŋ kʰ œ j p a s t j ɔ u r t n ʏ n
innkaupastjórnun	ɪ ŋ kʰ œ j p a s t j ɔ u r t n ʏ n
innkaupastofnunar	ɪ ŋ k au p a s t ɔ p n ʏ n a r
innkaupum	ɪ ŋ k au p ʏ m
innkeyrslu	ɪ ɲ cʰ ɛ j r̥ s t l ʏ
innkirtlasérfræðingurinn	ɪ ɲ c ɪ r̥ h t l a s j ɛ r̥ f r a j ð i ŋ k ʏ r ɪ n
innlausn	ɪ n l œ j s t n̥
innlausnar	ɪ n l œ j s t n a r
innsoginu	ɪ n s ɔ j ɪ n ʏ
innstreymisvatn	ɪ n s t r ɛ j m ɪ s v a h t n̥
íkveikju	iː kʰ v ɛ j c ʏ
ísafjarðarbær	iː s a f j a r ð a r̥ p aː j r
ísafjarðarprófastsdæma	iː s a f j a r ð a r̥ pʰ r ɔː u f a s t a j m a
ísafjarðarprófastsdæma	iː s a f j a r ð a r̥ pʰ r ɔː u f a s t a j m a
íseygt	iː s ɛ j x t
ísheimar	iː s h ɛ j m a r
ískjóa	iː s c ɔ u a
Íslandsbanka	i s t l a n t s p a n̥ k a
Íslandsbanki	i s t l a n t s p a ɲ̊ c ɪ
íslandsfengs	i s t l a n t s f ɛ j ŋ s
íslandsmeistarakeppni	i s t l a n t s m ɛ j s t a r a cʰ ɛ h p n ɪ
íslandsmeistaramótsins	i s t l a n t s m ɛ j s t a r a m ɔː u t s ɪ n s
íslandsmeistaramótsins	i s t l a n t s m ɛ j s t a r a m ɔː u t s ɪ n s
íslandsmeistarans	i s t l a n t s m ɛ j s t a r a n s
íslandspóst	i s t l a n t s pʰ ɔ u s t
íslandsskeið	i s t l a n t c ɛː j ð
ívarsdóttir	iː v a r̥ s t ɔ u h t ɪ r
íþróttabandalag	iː θ r ɔ u h t a p a n t a l a ɣ
íþróttafatnað	iː θ r ɔ u h t a f a h t n a ð
íþróttagallar	iː θ r ɔ u h t a k a l a r
íþróttagólf	iː θ r ɔ u h t a k ɔ u l v
íþróttahöllum	iː θ r ɔ u h t a h œ t l ʏ m
íþróttakennaraskóli	iː θ r ɔ u h t a cʰ ɛ n a r a s k ɔː u l ɪ
íþróttakeppni	iː θ r ɔ u h t a cʰ ɛ h p n ɪ
íþróttaljósmyndun	iː θ r ɔ u h t a l j ɔː u s m ʏ n t ʏ n
íþróttamannanefnd	iː θ r ɔ u h t a m a n a n ɛ m t
íþróttasamband	iː θ r ɔ u h t a s a m p a n t
íþróttaskó	iː θ r ɔ u h t a s k ɔː u
íþróttastarfið	iː θ r ɔ u h t a s t a r v ɪ ð
íþróttastjórnun	iː θ r ɔ u h t a s t j ɔ u r t n ʏ n
íþróttatengt	iː θ r ɔ u h t a tʰ ɛ j ŋ̊ t
íþróttatengt	iː θ r ɔ u h t a tʰ ɛ j ŋ̊ t
íþróttaviku	iː θ r ɔ u h t a v ɪː k ʏ
íþróttavöllum	iː θ r ɔ u h t a v œ t l ʏ m
jaðarhópum	j aː ð a r h ɔː u p ʏ m
jafnstór	j a p s t ɔː u r
jarðefnaeldsneyti	j a r ð ɛ p n a ɛ l t s t n ɛ j t ɪ
jarðhitaskólans	j a r ð h ɪ t a s k ɔː u l a n s
jarðskjálftamælar	j a r ð s c au l̥ t a m aː j l a r
jarðtauga	j a r ð t œ j ɣ a
jarðyrkjuverkfæri	j a r ð ɪ r̥ c ʏ v ɛ r̥ k f a j r ɪ
kaffihúsaskákmaður	kʰ a f ɪ h u s a s k aː u k m a ð ʏ r
kaflaheiti	kʰ a p l a h ɛː j t ɪ
kalkmjólkinni	kʰ a l̥ k m j ɔ u l̥ c ɪ n ɪ
kallhnaus	kʰ a t l̥ n̥ œ j s
kambafólkinu	kʰ a m p a f ɔ u l̥ c ɪ n ʏ
kanavænir	kʰ aː n a v aː j n ɪ r
kankvís	k a n̥ k v i s
kankvíslega	k a n̥ k v i s t l ɛ ɣ a
kantlengd	kʰ a n̥ t l ɛ j ŋ t
kantsteinarnir	kʰ a n̥ t s t ɛ j n a t n ɪ r
kapelluhraun	kʰ aː p ɛ t l ʏ r̥ œː j n
karlasveitir	kʰ a r t l a s v ɛː j t ɪ r
karlfólk	kʰ a r t l f ɔ u l̥ k
karlpersónur	kʰ a r̥ t l pʰ ɛ r̥ s ɔ u n ʏ r
kartöflumauki	kʰ a r̥ t œ p l ʏ m œː j c ɪ
kastlengd	kʰ a s t l ɛ j ŋ t
kattarattaey	kʰ a h t a r a h t a ɛ j
Kaupangi	k œyː p a ɲ c ɪ
kaupfélagshret	kʰ œ j f j ɛ l a k s r̥ ɛː t
kauphallar	kʰ œː j p h a t l a r
kaupmáttarauka	kʰ œː j p m au h t a r œː j k a
kaupmáttarhrap	kʰ œː j p m au h t a r̥ aː p
kaupskipum	kʰ œ j p s c ɪ p ʏ m
kaust	kʰ œː j s t
keiluhöllina	cʰ ɛː j l ʏ h œ t l ɪ n a
keilukvöldi	cʰ ɛː j l ʏ kʰ v œ l t ɪ
keisaranna	cʰ ɛː j s a r a n a
keisarasoninn	cʰ ɛː j s a r a s ɔː n ɪ n
kengbogin	c ei ŋ p ɔ j ɪ n
kengboginn	c ei ŋ p ɔ j ɪ n
kengúru	cʰ ɛ ŋ k u r ʏ
kennaradeildar	cʰ ɛ n a r a t ɛ j l t a r
kennaratyggjó	cʰ ɛ n a r a tʰ ɪ c ɔ u
kennslubókum	cʰ ɛ n s t l ʏ p ɔː u k ʏ m
kennslugrein	cʰ ɛ n s t l ʏ k r ɛː j n
kennsluleiðbeiningar	cʰ ɛ n s t l ʏ l ɛ j ð p ɛ j n i ŋ k a r
kennslutækni	cʰ ɛ n s t l ʏ tʰ a j h k n ɪ
keppnisgreina	cʰ ɛ h p n ɪ s k r ɛ j n a
keppnisnámskeiðinu	cʰ ɛ h p n ɪ s n au m s c ɛ j ð ɪ n ʏ
keppnisskráningunni	cʰ ɛ h p n ɪ s k r aː u n i ŋ k ʏ n ɪ
kerfisfræðilegan	cʰ ɛ r v ɪ s f r a j ð ɪ l ɛ ɣ a n
kerfisstjórar	cʰ ɛ r v ɪ s t j ɔː u r a r
kerfisstjórnun	cʰ ɛ r v ɪ s t j ɔ u r t n ʏ n
kindarhræ	cʰ ɪ n t a r̥ a j
kinnfiskasoginn	c ɪ n f ɪ s k a s ɔː j ɪ n
kinnskjótt	cʰ ɪ n s c ɔ u h t
kirkjubæjarklausturs	cʰ ɪ r̥ c ʏ p a j a r kʰ l œ j s t ʏ r̥ s
kirkjubæjarklausturs	cʰ ɪ r̥ c ʏ p a j a r kʰ l œ j s t ʏ r̥ s
kirkjudeild	cʰ ɪ r̥ c ʏ t ɛ j l t
kirkjudeildum	cʰ ɪ r̥ c ʏ t ɛ j l t ʏ m
kirkjugólfi	cʰ ɪ r̥ c ʏ k ɔ u l v ɪ
kirkjutengdum	cʰ ɪ r̥ c ʏ tʰ ɛ j ŋ t ʏ m
kirkjutónlistin	cʰ ɪ r̥ c ʏ tʰ ɔ u n l ɪ s t ɪ n
kjarakaup	cʰ aː r a kʰ œː j p
kjarnabókin	cʰ a r t n a p ɔː u c ɪ n
kjarnadeildafruma	cʰ a r t n a t ɛ j l t a f r ʏː m a
kjarnavopnaáætlanir	cʰ a r t n a v ɔ h p n a aː u a j h t l a n ɪ r
kjarnavopnaáætlanir	cʰ a r t n a v ɔ h p n a aː u a j h t l a n ɪ r
kjarnorkusprengju	cʰ a r t n ɔ r̥ k ʏ s p r ɛ j ɲ c ʏ
kjánum	cʰ aː u n ʏ m
kjóahrauni	cʰ ɔː u a r̥ œː j n ɪ
kjóahrauni	cʰ ɔː u a r̥ œː j n ɪ
kjúklingabóndi	cʰ u h k l i ŋ k a p ɔ u n t ɪ
kjúklingasneiðar	cʰ u h k l i ŋ k a s t n ɛ j ð a r
kjördæmabreytinguna	cʰ œ r t a j m a p r ɛː j t i ŋ k ʏ n a
kjördæmabreytinguna	cʰ œ r t a j m a p r ɛː j t i ŋ k ʏ n a
kjörgengi	cʰ œ r̥ c ɛ j ɲ c ɪ
kjörstjórn	cʰ œ r̥ s t j ɔ u r t n̥
kjötframleiðslu	cʰ œː t f r a m l ɛ j ð s t l ʏ
kjöthitamælir	cʰ œː t h ɪ t a m aː j l ɪ r
klaufa	kʰ l œː j v a
klaufhvarf	kʰ l œː j f kʰ v a r v
klaufi	kʰ l œː j v ɪ
klausturheit	kʰ l œ j s t ʏ r h ɛː j t
klausturheit	kʰ l œ j s t ʏ r h ɛː j t
klausturskólunum	kʰ l œ j s t ʏ r s k ɔː u l ɔ n ʏ m
klausturskólunum	kʰ l œ j s t ʏ r s k ɔː u l ɔ n ʏ m
klárhrossum	kʰ l aː u r̥ ɔ s ʏ m
klemensdóttir	kʰ l ɛː m ɛ n s t ɔ u h t ɪ r
kleópatra	kʰ l ɛ ɔ u p aː t r a
kleyft	kʰ l ɛ j f t
kleyfþol	kʰ l ɛ j f θ ɔ l
klifhraun	kʰ l ɪː f r̥ œ j n
klónaður	kʰ l ɔː u n a ð ʏ r
klónar	kʰ l ɔː u n a r
klóninu	kʰ l ɔː u n ɪ n ʏ
klórbrómkolefnissambanda	kʰ l ɔː u r p r ɔ u m kʰ ɔː l ɛ p n ɪ s a m p a n t a
klórflúorkolefni	kʰ l ɔː u r̥ f l u ɔ r kʰ ɔː l ɛ p n ɪ
klórflúors	kʰ l ɔː u r̥ f l u ɔ r̥ s
klukknahreim	kʰ l ʏ h k n a r̥ ɛ j m
klæðninganna	kʰ l a j ð n i ŋ k a n a
klæðningin	kʰ l a j ð n i ɲ c ɪ n
klæðskerinn	kʰ l a j ð s c ɛ r ɪ n
knattspyrnudómstóls	kʰ n a h t s p ɪ r t n ʏ t ɔ u m s t ɔ u l s
knattspyrnuleikur	kʰ n a h t s p ɪ r t n ʏ l ɛː j k ʏ r
kokhraust	kʰ ɔ k r̥ œ j s t
kokteila	kʰ ɔ k t ɛ j l a
kokteilum	kʰ ɔ k t ɛ j l ʏ m
kolbeinsdóttur	kʰ ɔ l p ɛ j n s t ɔ u h t ʏ r
kolbeinsdóttur	kʰ ɔ l p ɛ j n s t ɔ u h t ʏ r
kolbeinssyni	kʰ ɔ l p ɛ j n s ɪː n ɪ
kolefnisatómum	kʰ ɔː l ɛ p n ɪ s aː t ɔ u m ʏ m
kollugerðisengi	kʰ ɔ t l ʏ c ɛ r ð ɪ s ɛ j ɲ c ɪ
kommúnistastjórnin	kʰ ɔ m u n ɪ s t a s t j ɔ u r t n ɪ n
konkret	kʰ ɔ ŋ̊ k r ɛ t
kopardælur	kʰ ɔː p a r t aː j l ʏ r
koparháfur	kʰ ɔː p a r h aː u v ʏ r
koppasleikjur	kʰ ɔ h p a s t l ɛ j c ʏ r
korngeymsla	kʰ ɔ r t n̥ k ɛ j m s t l a
kortafyrirtækjunum	kʰ ɔ r̥ t a f ɪː r ɪ r tʰ aː j c ɔ n ʏ m
kosningabæra	kʰ ɔ s t n i ŋ k a p a j r a
kosningastjóri	kʰ ɔ s t n i ŋ k a s t j ɔː u r ɪ
kostakaup	kʰ ɔ s t a kʰ œː j p
kostnaðargreiningu	kʰ ɔ s t n a ð a r k r ɛː j n i ŋ k ʏ
kostnaðarreikninga	kʰ ɔ s t n a ð a r ɛ j h k n i ŋ k a
Kópavogi	k ouː p a v ɔː j ɪ
Kópavoginn	k ouː p a v ɔː j ɪ n
Kópavoginum	k ouː p a v ɔː j ɪ n ʏ m
krabbameinslyf	kʰ r a p a m ɛ j n s l ɪː v
krabbaveiðisvæðin	kʰ r a p a v ɛ j ð ɪ s v a j ð ɪ n
krabbaveiðisvæðin	kʰ r a p a v ɛ j ð ɪ s v a j ð ɪ n
kraftvægismælingar	kʰ r a f t v a j ɪ s m a j l i ŋ k a r
krangalegur	k r a ŋ k a l ɛ ɣ ʏ r
krankleika	k r a ŋ̊ k l ei k a
krásaborð	kʰ r aː u s a p ɔ r ð
kreditkortafyrirtæki	kʰ r ɛː t i t kʰ ɔ r̥ t a f ɪː r ɪ r tʰ a j c ɪ
kristaltært	kʰ r ɪ s t a l t a j r̥ t
kristindóminum	kʰ r ɪ s t ɪ n t ɔː u m ɪ n ʏ m
kristmannsdóttir	kʰ r ɪ s t m a n s t ɔ u h t ɪ r
krókdal	kʰ r ɔː u k t a l
krókhálsi	kʰ r ɔː u k h au l s ɪ
krómaða	kʰ r ɔː u m a ð a
króms	kʰ r ɔ u m s
krónosar	kʰ r ɔː u n ɔ s a r
krónuverð	kʰ r ɔː u n ʏ v ɛ r ð
krumshólum	kʰ r ʏ m s h ɔ u l ʏ m
kröfugönguna	kʰ r œː v ʏ k œ j ŋ k ʏ n a
kröfulausa	kʰ r œː v ʏ l œː j s a
kuldakvein	kʰ ʏ l t a kʰ v ɛː j n
kuldaskó	kʰ ʏ l t a s k ɔː u
kurteisishjal	kʰ ʏ r̥ t ɛ j s ɪ s ç aː l
kvaðratsútreikningum	kʰ v a ð r a t s uː t r ɛ j h k n i ŋ k ʏ m
kvenhormónum	kʰ v ɛ n h ɔ r m ɔ u n ʏ m
kvenkyn	k v ɛ n c ɪ n
kvenkynið	k v ɛ n c ɪ n ɪ ð
kvenkyns	k v ɛ n c ɪ n s
kvenkynsnafnorð	kʰ v ɛ ɲ cʰ ɪ n s t n a p n ɔ r ð
kvennarannsóknir	kʰ v ɛ n a r a n s ɔ u h k n ɪ r
kvennareið	kʰ v ɛ n a r ɛː j ð
kvennasveitir	kʰ v ɛ n a s v ɛː j t ɪ r
kviðarholsátfrumur	kʰ v ɪː ð a r h ɔ l s aː u t f r ʏ m ʏ r
kvikmyndafyrirtækið	kʰ v ɪː k m ɪ n t a f ɪː r ɪ r tʰ a j c ɪ ð
kvikmyndaleikstjóranum	kʰ v ɪː k m ɪ n t a l ɛː j k s t j ɔ u r a n ʏ m
kvikmyndaleikstjóranum	kʰ v ɪː k m ɪ n t a l ɛː j k s t j ɔ u r a n ʏ m
kvótakerfis	kʰ v ɔː u t a cʰ ɛ r v ɪ s
kvótar	kʰ v ɔː u t a r
kvótasölu	kʰ v ɔː u t a s œː l ʏ
kvöldheimsókn	kʰ v œ l t h ɛ j m s ɔ u h k n̥
kvöldheimsókn	kʰ v œ l t h ɛ j m s ɔ u h k n̥
kvöldkjólum	kʰ v œ l t cʰ ɔ u l ʏ m
kvöldlagi	k v œ l t l a j ɪ
kvöldveislu	kʰ v œ l t v ɛ j s t l ʏ
kylfulengdir	cʰ ɪ l v ʏ l ɛ j ŋ t ɪ r
kylfusvein	cʰ ɪ l v ʏ s v ɛː j n
kynbótahross	cʰ ɪ m p ɔ u t a r̥ ɔ s
kynbótanefnd	cʰ ɪ m p ɔ u t a n ɛ m t
kynbótarækt	cʰ ɪ m p ɔ u t a r a j x t
kynbótarækt	cʰ ɪ m p ɔ u t a r a j x t
kynbótastarf	cʰ ɪ m p ɔ u t a s t a r v
kynbótastöð	cʰ ɪ m p ɔ u t a s t œː ð
kynfræðslu	cʰ ɪ n f r a j ð s t l ʏ
kynhreina	cʰ ɪː n r̥ ɛ j n a
kynningarbækling	cʰ ɪ n i ŋ k a r p a j h k l i ŋ k
kynningarbæklingi	cʰ ɪ n i ŋ k a r p a j h k l i ɲ c ɪ
kynningarbæklingur	cʰ ɪ n i ŋ k a r p a j h k l i ŋ k ʏ r
kynningardeildar	cʰ ɪ n i ŋ k a r t ɛ j l t a r
kynningarnámskeið	cʰ ɪ n i ŋ k a r n au m s c ɛ j ð
kynsjúkdóma	cʰ ɪ n s j u k t ɔː u m a
kynslóðabilin	cʰ ɪ n s t l ɔ u ð a p ɪː l ɪ n
kynslóðaskipti	cʰ ɪ n s t l ɔ u ð a s c ɪ f t ɪ
köngulóarvefur	k ou ŋ k ʏ l ou a v ɛː v ʏ r
köngulóarvefurinn	k ou ŋ k ʏ l ou a v ɛː v ʏ r ɪ n
köngulóarvefurinn	k ou ŋ k ʏ l ou a v ɛ v ʏ r ɪ n
köngurló	k œ n k ʏ l ouː
köngurlóarvefur	k ou ŋ k ʏ l ou a v ɛ v ʏ r
lagabreytinga	l aː ɣ a p r ɛː j t i ŋ k a
lagaumhverfi	l aː ɣ a ʏ m k v ɛ r v ɪ
lagaumhverfi	l aː ɣ a ʏ m x v ɛ r v ɪ
lagi	l aː j ɪ
lambalæri	l a m p a l aː j r ɪ
lambalærissneiðar	l a m p a l a j r ɪ s t n ɛː j ð a r
lambalærissneiðar	l a m p a l a j r ɪ s t n ɛː j ð a r
landafræðiprófin	l a n t a f r a j ð ɪ p r ɔː u ɪ n
landafræðiprófin	l a n t a f r a j ð ɪ p r ɔː u ɪ n
landamæravörðurinn	l a n t a m a j r a v œ r ð ʏ r ɪ n
landbúnaðardeild	l a n t p u n a ð a r t ɛ j l t
landbúnaðartækni	l a n t p u n a ð a r tʰ a j h k n ɪ
landeigandi	l a n t ɛ j ɣ a n t ɪ
landey	l a n t ɛ j
landfræðingur	l a n t f r a j ð i ŋ k ʏ r
landgræðsluverkefni	l a n t k r a j ð s t l ʏ v ɛ r̥ k ɛ p n ɪ
landmælingakort	l a n t m a j l i ŋ k a kʰ ɔ r̥ t
landráðunaut	l a n t r au ð ʏ n œː j t
Landsbanka	l a n t s p a ŋ̊ k a
Landsbankann	l a n t s p a ŋ̊ k a n
Landsbankans	l a n t s p a ŋ̊ k a n s
Landsbankanum	l a n t s p a ŋ̊ k a n ʏ m
Landsbanki	l a n t s p a ŋ̊ c ɪ
Landsbanki	l a n s p a ɲ̊ c ɪ
Landsbankinn	l a n t s p a ŋ̊ c ɪ n
Landsbankinn	l a n s p a ɲ̊ c ɪ n
landslagsheildir	l a n t s t l a k s h ɛ j l t ɪ r
landsliðshópurinn	l a n t s t l ɪ ð s h ɔː u p ʏ r ɪ n
landsliðstreyju	l a n t s t l ɪ ð s t r ɛː j ʏ
landsmótsár	l a n t s m ɔ u t s aː u r
landsmótsár	l a n t s m ɔ u t s aː u r
landsstjórnar	l a n t s t j ɔ u r t n a r
langa	l a ŋ k a
Langadal	l a ŋ k a t aː l
Langadal	l a ŋ k a t a l
langað	l a ŋ k a ð
langaði	l a ŋ k a ð ɪ
langafa	l a ŋ k a v a
langafi	l a ŋ k a v ɪ
Langagerði	l a ŋ k a k ɛ r ð ɪ
langalgengasta	l au ŋ k a l c ɛ j ŋ k a s t a
langalöngu	l a ŋ k a l œy ŋ k ʏ
langamma	l a ŋ k a m a
langan	l a ŋ k a n
Langanes	l a ŋ k a n ɛː s
Langanesi	l a ŋ k a n ɛː s
Langanesi	l a ŋ k a n ɛː s ɪ
langanir	l a ŋ k a n ɪ r
langar	l a ŋ k a r
Langarima	l a ŋ k a r ɪ m a
langasjó	l au ŋ k a s j ɔː u
langavitleysa	l au ŋ k a v ɪ h t l ɛ j s a
langbest	l a ŋ p ɛ s t
langbesta	l a ŋ p ɛ s t a
langborð	l a ŋ p ɔ r ð
langdregið	l a ŋ t r ei j ɪ ð
langdregin	l a ŋ t r ei j ɪ n
langdreginn	l a ŋ t r ei j ɪ n
langdregnu	l a ŋ t r ei k n ʏ
langdrægu	l au ŋ k t r a j ɣ ʏ
langdvölum	l a ŋ t v œ l ʏ m
langferð	l a ŋ k f ɛ r ð
langferðabíllinn	l a ŋ k f ɛ r ð a p i t l ɪ n
langflest	l a ŋ k f l ɛ s t
langflestar	l a ŋ k f l ɛ s t a r
langflestir	l a ŋ k f l ɛ s t ɪ r
langflestum	l a ŋ k f l ɛ s t ʏ m
langframa	l a ŋ k f r a m a
langhlaup	l au ŋ k l̥ œ j p
langhlauparar	l au ŋ k l̥ œ j p a r a r
Langholti	l a ŋ k h ɔ l̥ t ɪ
Langholtskirkja	l a ŋ k h ɔ l̥ t s c ɪ r̥ c a
Langholtskirkju	l a ŋ k h ɔ l̥ t s c ɪ r̥ c ʏ
Langholtsskóla	l a ŋ k h ɔ l̥ t s k ouː l a
Langholtssóknar	l a ŋ k h ɔ l̥ t s ou h k n a r
Langholtsvegi	l a ŋ k h ɔ l̥ t s v eiː j ɪ
Langholtsvegi	l a ŋ k h ɔ l̥ t s v ei j ɪ
langhund	l a ŋ k h ʏ n t
langi	l a ɲ c ɪ
langinn	l a ɲ c ɪ n
langir	l a ɲ c ɪ r
Langir	l a ŋ k ɪ r
langisjór	l au ɲ c ɪ s j ɔː u r
langjökli	l a ŋ c œ h k l ɪ
langjökul	l a ŋ c œ k ʏ l
langkeyrslu	l au ŋ k cʰ ɛ j r̥ s t l ʏ
langleiðina	l a ŋ k l ei ð ɪ n a
langlífi	l a ŋ k l i v ɪ
langmest	l a ŋ k m ɛ s t
langmestu	l a ŋ k m ɛ s t ʏ
langódýrast	l au ŋ k ɔː u t i r a s t
langra	l a ŋ k r a
langrar	l a ŋ k r a r
langri	l a ŋ k r ɪ
langs	l a ŋ s
langsamlega	l a ŋ k s a m l ɛ ɣ a
langskot	l a ŋ k s k ɔ t
langsótt	l a ŋ k s ou h t
langstærsta	l a ŋ k s t ai s t a
langstærsti	l a ŋ k s t ai s t ɪ
langstökki	l a ŋ k s t œ h c ɪ
langt	l a ŋ̊ t
langtíma	l a ŋ t i m a
langtímadjobb	l a ŋ t i m a t j ɔ p
langtímum	l a ŋ t i m ʏ m
langtum	l a ŋ̊ t ʏ m
langur	l a ŋ k ʏ r
langvarandi	l a ŋ k v a r a n t ɪ
langveikra	l a ŋ k v ei k r a
langveikum	l a ŋ k v ei k ʏ m
langvinn	l a ŋ k v ɪ n
langvinna	l a ŋ k v ɪ n a
langþreytt	l a ŋ k θ r ei h t
langþreyttir	l au ŋ k θ r ɛ j h t ɪ r
langþreyttur	l a ŋ k θ r ei h t ʏ r
langömmu	l a ŋ h œ m ʏ
langömmubörnin	l a ŋ h œ m ʏ p œ t n ɪ n
lanka	l a ŋ̊ k a
laufblaðinu	l œ j v p l a ð ɪ n ʏ
laufbrekku	l œ j v p r ɛ h k ʏ
laufferjum	l œ j f ɛ r j ʏ m
laufgun	l œ j v k ʏ n
laufpör	l œ j ʏ f pʰ œ r
laugardagsgangan	l œyː ɣ a r t a x s k a ŋ k a n
laugardagskvöldinu	l œː j ɣ a r t a k s kʰ v œ l t ɪ n ʏ
laugardagurinn	l œː j ɣ a r t aː ɣ ʏ r ɪ n
laugargötu	l œː j ɣ a k œː t ʏ
laugarnestanga	l œyː ɣ a r n ɛ s t a ŋ k a
laugavalladal	l œː j ɣ a v a t l a t aː l
laugdælir	l œ j ɣ t a j l ɪ r
laugdælir	l œ j ɣ t a j l ɪ r
laukar	l œː j k a r
launahækkunin	l œː j n a h a j h k ʏ n ɪ n
launahækkunin	l œː j n a h a j h k ʏ n ɪ n
launaleiðrétting	l œː j n a l ɛ j ð r j ɛ h t i ŋ k
launaleiðrétting	l œː j n a l ɛ j ð r j ɛ h t i ŋ k
launamiða	l œː j n a m ɪː ð a
launaráðningarsamningur	l œː j n a r au ð n i ŋ k a r s a m n i ŋ k ʏ r
launastefnu	l œː j n a s t ɛ p n ʏ
launatapi	l œː j n a tʰ aː p ɪ
launatapið	l œː j n a tʰ aː p ɪ ð
launatímabil	l œː j n a tʰ iː m a p ɪ l
launatöflum	l œː j n a tʰ œ p l ʏ m
launavinnu	l œː j n a v ɪ n ʏ
launmorð	l œ j n m ɔ r ð
lausafé	l œː j s a f j ɛː
lausafjárkaup	l œː j s a f j au r̥ kʰ œ j p
lausfryst	l œː j s f r ɪ s t
lausfrystar	l œː j s f r ɪ s t a r
lauslegt	l œː j s t l ɛ x t
lausnarinn	l œ j s t n a r ɪ n
lausnarlykils	l œ j s t n a r l ɪː c ɪ l s
lausnarveitingu	l œ j s t n a r v ɛ j t i ŋ k ʏ
lausnarveitingu	l œ j s t n a r v ɛ j t i ŋ k ʏ
lausnirnar	l œ j s t n ɪ t n a r
laxavinnslufyrirtækinu	l a k s a v ɪ n s t l ʏ f ɪː r ɪ r tʰ a j c ɪ n ʏ
laxdælu	l a k s t a j l ʏ
legsteinagerð	l ɛ k s t ɛ j n a c ɛ r ð
legusár	l ɛː ɣ ʏ s aː u r
leiðangra	l eiː ð a ŋ k r a
leiðangri	l eiː ð a ŋ k r ɪ
leiðangrinum	l eiː ð a ŋ k r ɪ n ʏ m
leiðangur	l eiː ð a ŋ k ʏ r
leiðangurinn	l eiː ð a ŋ k ʏ r ɪ n
leiðangursins	l eiː ð a ŋ k ʏ r̥ s ɪ n s
leiðarar	l ɛː j ð a r a r
leiðarkerfi	l ɛː j ð a r̥ cʰ ɛ r v ɪ
leiðarmerki	l ɛː j ð a r m ɛ r̥ c ɪ
leiðarpunkt	l ɛː j ð a r̥ pʰ u ŋ̊ t
leiðarpunktur	l ɛː j ð a r̥ pʰ u ŋ̊ t ʏ r
leiðarstef	l ɛː j ð a r̥ s t ɛː v
leiðarsteinninn	l ɛː j ð a r̥ s t ɛ j t n ɪ n
leiðbeinandinn	l ɛ j ð p ɛ j n a n t ɪ n
leiðbeininga	l ɛ j ð p ɛ j n i ŋ k a
leiðbeiningarnar	l ɛ j ð p ɛ j n i ŋ k a t n a r
leiðbeiningarreglum	l ɛ j ð p ɛ j n i ŋ k a r ɛ k l ʏ m
leiðbeiningaskjal	l ɛ j ð p ɛ j n i ŋ k a s c aː l
leiðindalífið	l ɛː j ð ɪ n t a l iː v ɪ ð
leiðindaveður	l ɛː j ð ɪ n t a v ɛː ð ʏ r
leiðinlegan	l ɛː j ð ɪ n l ɛː ɣ a n
leiðinlegasti	l ɛː j ð ɪ n l ɛː ɣ a s t ɪ
leiðinlegum	l ɛː j ð ɪ n l ɛː ɣ ʏ m
leiðni	l ɛ j ð n ɪ
leiðsagnarreglu	l ɛ j ð s a k n a r ɛ k l ʏ
leiðtogaskóli	l ɛ j ð tʰ ɔ ɣ a s k ɔː u l ɪ
leiðtogaskóli	l ɛ j ð tʰ ɔ ɣ a s k ɔː u l ɪ
leigjum	l ɛː j ʏ m
leigubifreiðarstjóra	l ɛː j ɣ ʏ p ɪ v r ɛ j ð a r s t j ɔː u r a
leigubifreiðarstjóra	l ɛː j ɣ ʏ p ɪ v r ɛ j ð a r s t j ɔː u r a
leigubílaakstur	l ɛː j ɣ ʏ p i l a a k s t ʏ r
leigubílar	l ɛː j ɣ ʏ p iː l a r
leigugjald	l ɛː j ɣ ʏ c a l t
leiguhross	l ɛː j ɣ ʏ r̥ ɔ s
leiguna	l ɛː j ɣ ʏ n a
leigusala	l ɛː j ɣ ʏ s aː l a
leigusamningur	l ɛː j ɣ ʏ s a m n i ŋ k ʏ r
leikarasystkinin	l ɛː j k a r a s ɪ s c ɪ n ɪ n
leikbrot	l ɛː j k p r ɔ t
leikbönn	l ɛː j k p œ n
leikfangabúðina	l ɛ j k f au ŋ k a p uː ð ɪ n a
leikfangabyssu	l ɛ j k f au ŋ k a p ɪ s ʏ
leikfangaland	l ɛ j k f au ŋ k a l a n t
leikgrind	l ɛ j k r ɪ n t
leikhúslífi	l ɛː j k h u s l iː v ɪ
leikhússtjóranum	l ɛː j k h u s t j ɔː u r a n ʏ m
leikhússtjóranum	l ɛː j k h u s t j ɔː u r a n ʏ m
leikjafjölda	l ɛː j c a f j œ l t a
leikjatölvu	l ɛː j c a tʰ œ l v ʏ
leikjavinnslu	l ɛː j c a v ɪ n s t l ʏ
leikkafli	l ɛː j kʰ a p l ɪ
leiklistarhæfileika	l ɛː j k l ɪ s t a r̥ h aː j v ɪ l ɛ j k a
leiklistarhæfileika	l ɛː j k l ɪ s t a r̥ h aː j v ɪ l ɛ j k a
leikmannaskipti	l ɛː j k m a n a s c ɪ f t ɪ
leikmynda	l ɛː j k m ɪ n t a
leikmyndateiknari	l ɛː j k m ɪ n t a t ɛ j h k n a r ɪ
leikreglna	l ɛː j k r ɛ k l n a
leikritasafn	l ɛː j k r ɪ t a s a p n̥
leikrænni	l ɛː j k r a j t n ɪ
leikrænni	l ɛː j k r a j t n ɪ
leikskáldinu	l ɛː j k s k au l t ɪ n ʏ
leikskólanefnd	l ɛː j k s k ɔ u l a n ɛ m t
leikskólanefnd	l ɛː j k s k ɔ u l a n ɛ m t
leikskólastarf	l ɛː j k s k ɔ u l a s t a r v
leikskólastarf	l ɛː j k s k ɔ u l a s t a r v
leikstíll	l ɛː j k s t i t l̥
leikstöðina	l ɛː j k s t œ ð ɪ n a
leiktilþrif	l ɛː j k tʰ ɪ l θ r ɪ v
leirhnjúkur	l ɛ j r̥ n̥ j u k ʏ r
leirkenndum	l ɛ j r̥ cʰ ɛ n t ʏ m
leirker	l ɛ j r̥ cʰ ɛ r
leirklessa	l ɛ j r̥ kʰ l ɛ s a
leirpyttir	l ɛ j r̥ pʰ ɪ h t ɪ r
leitarkönguló	l ɛː j t a r kʰ œ ŋ k ʏ l ɔ u
leitarkönguló	l ɛː j t a r kʰ œ ŋ k ʏ l ɔ u
leitarkönguló	l ɛː j t a r kʰ œ ŋ k ʏ l ɔ u
leitarliðir	l ɛː j t a r l ɪː ð ɪ r
leitarliður	l ɛː j t a r l ɪː ð ʏ r
leitarorðin	l ɛː j t a r ɔ r ð ɪ n
leitartrénu	l ɛː j t a r tʰ r j ɛː n ʏ
leitarvefur	l ɛː j t a r v ɛː v ʏ r
leitarvélar	l ɛː j t a r v j ɛː l a r
leitarvélum	l ɛː j t a r v j ɛː l ʏ m
lengdin	l ɛ j ŋ t ɪ n
lengdinni	l ɛ j ŋ t ɪ n ɪ
lenging	l ɛ j ɲ c i ŋ k
lengingar	l ɛ j ɲ c i ŋ k a r
lengstur	l ɛ j ŋ s t ʏ r
leturháð	l ɛː t ʏ r h aː u ð
leyfða	l ɛ j v ð a
leyfisskyldu	l ɛː j v ɪ s c ɪ l t ʏ
leyndardómarnir	l ɛ j n t a r t ɔː u m a t n ɪ r
leyndardómarnir	l ɛ j n t a r t ɔː u m a t n ɪ r
leyndardóminum	l ɛ j n t a r t ɔː u m ɪ n ʏ m
leyndardóminum	l ɛ j n t a r t ɔː u m ɪ n ʏ m
leynifréttir	l ɛː j n ɪ f r j ɛ h t ɪ r
leynihreyfing	l ɛː j n ɪ r̥ ɛː j v i ŋ k
leynihundur	l ɛː j n ɪ h ʏ n t ʏ r
leynilegri	l ɛː j n ɪ l ɛ ɣ r ɪ
leyniskytta	l ɛː j n ɪ s c ɪ h t a
leyniskyttu	l ɛː j n ɪ s c ɪ h t ʏ
leysiensíma	l ɛː j s ɪ ɛ n s i m a
leysingu	l ɛː j s i ŋ k ʏ
leysingum	l ɛː j s i ŋ k ʏ m
liðugir	l ɪː ð ʏ j ɪ r
lillablár	l ɪ l a p l aː u r
limbó	l ɪ m p ɔ u
lindasókn	l ɪ n t a s ɔ u h k n̥
lindasóknar	l ɪ n t a s ɔ u h k n a r
listapóstinum	l ɪ s t a pʰ ɔ u s t ɪ n ʏ m
listaskólann	l ɪ s t a s k ɔː u l a n
listaverkabækur	l ɪ s t a v ɛ r̥ k a p aː j k ʏ r
listfræðingar	l ɪ s t f r a j ð i ŋ k a r
listhneigð	l ɪ s t n̥ ɛ j ɣ ð
litabókin	l ɪː t a p ɔː u c ɪ n
litabreytingu	l ɪː t a p r ɛː j t i ŋ k ʏ
litarhætti	l ɪː t a r h a j h t ɪ
litrófs	l ɪː t r ɔ u f s
litrófsgreiningar	l ɪː t r ɔ u f s k r ɛː j n i ŋ k a r
litrófsgreiningar	l ɪː t r ɔ u f s k r ɛː j n i ŋ k a r
litrófsgreiningu	l ɪː t r ɔ u f s k r ɛː j n i ŋ k ʏ
litrófsgreiningu	l ɪː t r ɔ u f s k r ɛː j n i ŋ k ʏ
ljóðadeild	l j ɔː u ð a t ɛ j l t
ljóðadeild	l j ɔː u ð a t ɛ j l t
ljósadýrð	l j ɔː u s a t i r ð
ljósafell	l j ɔː u s a f ɛ t l̥
ljósaleigu	l j ɔː u s a l ɛː j ɣ ʏ
ljósaleigu	l j ɔː u s a l ɛː j ɣ ʏ
ljósan	l j ɔː u s a n
ljósapera	l j ɔː u s a pʰ ɛː r a
ljósaperur	l j ɔː u s a pʰ ɛː r ʏ r
ljósastaurar	l j ɔː u s a s t œː j r a r
ljósastaurar	l j ɔː u s a s t œː j r a r
ljósastikuna	l j ɔː u s a s t ɪː k ʏ n a
ljósbrotsmælir	l j ɔː u s p r ɔ t s m a j l ɪ r
ljósbrotsmælir	l j ɔː u s p r ɔ t s m a j l ɪ r
ljóseinkenni	l j ɔː u s ɛ j ɲ cʰ ɛ n ɪ
ljóseinkenni	l j ɔː u s ɛ j ɲ cʰ ɛ n ɪ
ljóshærðar	l j ɔː u s h a j r ð a r
ljóshærðar	l j ɔː u s h a j r ð a r
ljóskastari	l j ɔː u s k a s t a r ɪ
ljóskerjum	l j ɔː u s cʰ ɛ r j ʏ m
ljósmagni	l j ɔː u s m a k n ɪ
ljósmyndamöppuna	l j ɔː u s m ʏ n t a m œ h p ʏ n a
ljósmyndasafns	l j ɔː u s m ʏ n t a s a p s
ljósmyndaskólanum	l j ɔː u s m ʏ n t a s k ɔː u l a n ʏ m
ljósmyndunarrúnt	l j ɔː u s m ʏ n t ʏ n a r u n̥ t
ljóspúls	l j ɔː u s p u l s
ljósritað	l j ɔː u s r ɪ t a ð
ljósritunarvélar	l j ɔː u s r ɪ t ʏ n a r v j ɛː l a r
ljósrofnun	l j ɔː u s r ɔ p n ʏ n
ljósstyrkleika	l j ɔː u s t ɪ r̥ k l ɛː j k a
ljósstyrkleika	l j ɔː u s t ɪ r̥ k l ɛː j k a
ljósuna	l j ɔː u s ʏ n a
ljósviti	l j ɔː u s v ɪ t ɪ
ljótasti	l j ɔː u t a s t ɪ
lofgerðarhrópið	l ɔ v c ɛ r ð a r̥ ɔː u p ɪ ð
loftaflsfræðileg	l ɔ f t a p l̥ s f r aː j ð ɪ l ɛ ɣ
loftflæðiuppsetningar	l ɔ f t f l a j ð ɪ ʏ h p s ɛ h t n i ŋ k a r
loftkæld	l ɔ f t cʰ a j l t
loftmeiri	l ɔ f t m ɛ j r ɪ
loftræstikerfum	l ɔ f t r a j s t ɪ cʰ ɛ r v ʏ m
loftræstingu	l ɔ f t r a j s t i ŋ k ʏ
loftskeytamaðurinn	l ɔ f t s c ɛ j t a m aː ð ʏ r ɪ n
logið	l ɔ k n ɪ ð
loginn	l ɔ j ɪ n
logsuðugleraugu	l ɔ k s ʏ ð ʏ k l ɛː r œ j ɣ ʏ
lokadansleikinn	l ɔː k a t a n s l ɛ j c ɪ n
lokaeinkun	l ɔː k a ɛ j ŋ̊ k ʏ n
lokaeinkunnin	l ɔː k a ɛ j ŋ̊ k ʏ n ɪ n
lokahófi	l ɔː k a h ɔː u v ɪ
lokaleik	l ɔː k a l ɛː j k
lokaleikur	l ɔː k a l ɛː j k ʏ r
lokamótið	l ɔː k a m ɔː u t ɪ ð
lokatónleika	l ɔː k a tʰ ɔ u n l ɛ j k a
lokatónleika	l ɔː k a tʰ ɔ u n l ɛ j k a
lokaumferð	l ɔː k a ʏ m f ɛ r ð
lokaumferðinni	l ɔː k a ʏ m f ɛ r ð ɪ n ɪ
lokaundirbúningi	l ɔː k a ʏ n t ɪ r p uː n i ɲ c ɪ
lundaveiðar	l ʏ n t a v ɛː j ð a r
lungnasjúkdóma	l u ŋ n a s j uː k t ɔ u m a
lyfjafræðisambandsins	l ɪ v j a f r a j ð ɪ s a m p a n t s ɪ n s
lyfjafyrirtækisins	l ɪ v j a f ɪ r ɪ r tʰ aː j c ɪ s ɪ n s
lyfjakaup	l ɪ v j a kʰ œː j p
lyfjarannsóknir	l ɪ v j a r a n s ɔ u h k n ɪ r
lyfjasameindum	l ɪ v j a s a m ɛ j n t ʏ m
lyfjatæknabraut	l ɪ v j a tʰ a j h k n a p r œː j t
lyfjatæknabraut	l ɪ v j a tʰ a j h k n a p r œː j t
lynggróður	l i ŋ k r ɔ u ð ʏ r
lynghæna	l i ŋ k h a j n a
löngu	l œ ŋ k ʏ
Lönguhlíð	l œ ŋ k ʏ l̥ i ð
löngum	l œ ŋ k ʏ m
Löngusker	l œ ŋ k ʏ s k ɛː r
Löngusker	l œ ŋ k ʏ s k ɛ r
magadansmær	m aː ɣ a t a n s m a j r
magakveisu	m aː ɣ a kʰ v ɛː j s ʏ
magi	m aː j ɪ
maginn	m aː j ɪ n
magisternámi	m aː c ɪ s t ɛ r n au m ɪ
magngreiningar	m a k n k r ɛ j n i ŋ k a r
maíflugnaveislu	m aː j f l ʏ k n a v ɛ j s t l ʏ
malarnámu	m aː l a r n aː u m ʏ
mammografíutæki	m a m ɔ k r aː f i j ʏ tʰ aː j c ɪ
Manga	m a ŋ k a
mangan	m a ŋ k a n
Mangi	m a ɲ c ɪ
mangó	m a ŋ k ou
mannauðsstefnu	m a n œ j ð s t ɛ p n ʏ
manngeng	m a ɲ c ɛ j ŋ k
mannréttindafræðing	m a n r j ɛ h t ɪ n t a f r aː j ð i ŋ k
mannsblóð	m a n s p l ɔ u ð
mannvirkjalagið	m a n v ɪ r̥ c a l a j ɪ ð
maórísku	m aː ɔ u r i s k ʏ
marengs	m aː r ɛ j ŋ s
margbreytileg	m a r k p r ɛ j t ɪ l ɛː ɣ
margbreytilegum	m a r k p r ɛ j t ɪ l ɛː ɣ ʏ m
margeirssyni	m a r c ɛ j r̥ s ɪː n ɪ
margmiðlunarskólann	m a r k m ɪ ð l ʏ n a r̥ s k ɔː u l a n
margmiðlunartæknin	m a r k m ɪ ð l ʏ n a r̥ tʰ a j h k n ɪ n
margreyndur	m a r k r ɛ j n t ʏ r
margrómaða	m a r k r ɔ u m a ð a
margyfirfór	m a r k ɪ v ɪ r f ɔː u r
markareikningurinn	m a r̥ k a r ɛ j h k n i ŋ k ʏ r ɪ n
markhópinn	m a r̥ k h ɔ u p ɪ n
marklaust	m a r̥ k l œ j s t
markpóst	m a r̥ k pʰ ɔ u s t
marssósa	m a r̥ s ɔ u s a
mastersnámi	m a s t ɛ r̥ s n aː u m ɪ
matarkaup	m aː t a r̥ kʰ œː j p
matartónlist	m aː t a r̥ tʰ ɔ u n l ɪ s t
matlaukur	m aː t l œ j k ʏ r
matreiðslumaður	m aː t r ɛ j ð s t l ʏ m aː ð ʏ r
matstæki	m aː t s tʰ a j c ɪ
matvæladagur	m aː t v a j l a t aː ɣ ʏ r
matvælaflokkum	m aː t v a j l a f l ɔ h k ʏ m
matvælafyrirtæki	m aː t v a j l a f ɪː r ɪ r̥ tʰ a j c ɪ
matvælafyrirtækisins	m aː t v a j l a f ɪː r ɪ r̥ tʰ a j c ɪ s ɪ n s
matvælageirann	m aː t v a j l a c ɛː j r a n
matvælageirann	m aː t v a j l a c ɛː j r a n
matvælagreinum	m aː t v a j l a k r ɛː j n ʏ m
matvælagreinum	m aː t v a j l a k r ɛː j n ʏ m
matvælavinnslu	m aː t v a j l a v ɪ n s t l ʏ
mauraeitri	m œː j r a ɛː j t r ɪ
mauraeitri	m œː j r a ɛː j t r ɪ
mánudaginn	m auː n ʏ t aː j ɪ n
meðalframleiðsla	m ɛː ð a l f r a m l ɛ j ð s t l a
meðallaun	m ɛː ð a l auː n
meðalsteikt	m ɛː ð a l s t ɛ j x t
meðalstórra	m ɛː ð a l s t ɔ u r a
meðalsveiflutími	m ɛː ð a l s v ɛ j f l ʏ tʰ i m ɪ
megabæta	m ɛː k a p a j t a
megabæti	m ɛː k a p aː j t ɪ
meginbreytingin	m ɛ j ɪ n p r ɛː j t i ɲ c ɪ n
meginlandsmisgengið	m ɛ j ɪ n l a n t s m ɪː s c ɛ j ɲ c ɪ ð
meinafræðideild	m ɛː j n a f r a j ð ɪ t ɛ j l t
meinafræðideild	m ɛː j n a f r a j ð ɪ t ɛ j l t
meinafræðirannsókn	m ɛː j n a f r a j ð ɪ r a n s ɔ u h k n̥
meinafræðirannsókn	m ɛː j n a f r a j ð ɪ r a n s ɔ u h k n̥
meinafræðirannsókn	m ɛː j n a f r a j ð ɪ r a n s ɔ u h k n̥
meinbugi	m ɛ j m p ʏ j ɪ
meinbugi	m ɛ j m p ʏ j ɪ
meindýrið	m ɛ j n t i r ɪ ð
meinfyndið	m ɛ j n f ɪ n t ɪ ð
meini	m ɛː j n ɪ
meintri	m ɛ j n̥ t r ɪ
meinvarp	m ɛ j n v a r̥ p
meinvörp	m ɛ j n v œ r̥ p
meirháttar	m ɛ j r h au h t a r
meirihlutaeigandi	m ɛː j r ɪ l̥ ʏ t a ɛː j ɣ a n t ɪ
meistaradeildarinnar	m ɛ j s t a r a t ɛ j l t a r ɪ n a r
meistaradeildarsæti	m ɛ j s t a r a t ɛ j l t a r̥ s aː j t ɪ
meistaradeildarsæti	m ɛ j s t a r a t ɛ j l t a r̥ s aː j t ɪ
meistaraflokksráð	m ɛ j s t a r a f l ɔ k s r aː u ð
meistaraflokksráð	m ɛ j s t a r a f l ɔ k s r aː u ð
meistarastig	m ɛ j s t a r a s t ɪː ɣ
meistaratitil	m ɛ j s t a r a tʰ ɪː t ɪ l
meitluð	m ɛ j h t l ʏ ð
mengunarvörnum	m ɛ j ŋ k ʏ n a r v œ r t n ʏ m
menningarumræða	m ɛ n i ŋ k a r ʏ m r a j ð a
menntarannsóknir	m ɛ n̥ t a r a n s ɔ u h k n ɪ r
menntaskólanema	m ɛ n̥ t a s k ɔ u l a n ɛː m a
merkingarlaust	m ɛ r̥ c i ŋ k a r l œ j s t
metraleitar	m ɛː t r a l ɛː j t a r
meyjarbúðina	m ɛː j a r p uː ð ɪ n a
meyjarhaftið	m ɛː j a r h a f t ɪ ð
meyjarheiður	m ɛː j a r h ɛː j ð ʏ r
meyju	m ɛː j ʏ
meyvants	m ɛː j v a n̥ t s
Miðausturlöndum	m ɪː ð au s t ʏ r l œ n t ʏ m
miðdalsá	m ɪ ð t a l s aː u
miðflóttaafl	m ɪ ð f l ɔ u h t a a p l̥
miðgeisli	m ɪ ð ɛ j s t l ɪ
miðjureiturinn	m ɪ ð j ʏ r ɛː j t ʏ r ɪ n
Miðvangi	m ɪ ð v a ɲ c ɪ
miðvikudaginn	m ɪ ð v ɪ k ʏ t aː j ɪ n
mikilfenglegum	m ɪː c ɪ l f ɛ j ŋ k l ɛ ɣ ʏ m
millibankamarkaði	m ɪ t l ɪ p a ŋ̊ k a m a r̥ k a ð ɪ
milligöngufyrirtæki	m ɪ t l ɪ k œ j ŋ k ʏ f ɪː r ɪ r tʰ a j c ɪ
milligöngufyrirtæki	m ɪ t l ɪ k œ j ŋ k ʏ f ɪː r ɪ r tʰ a j c ɪ
milljónaborg	m ɪ l j ɔ u n a p ɔ r k
milljóninni	m ɪ l j ɔ u n ɪ n ɪ
minnihlutahóparnir	m ɪ n ɪ l̥ ʏ t a h ɔː u p a r t n ɪ r
misfórst	m ɪː s f ɔ u r̥ s t
misgóð	m ɪː s k ɔ u ð
misserishópa	m ɪ s ɛ r ɪ s h ɔː u p a
Mjóafirði	m j ɔː u a f ɪ r ð ɪ
mjóafjarðar	m j ɔː u a f j a r ð a r
mjóhryggsstuðningur	m j ɔː u r̥ ɪ k s t ʏ ð n i ŋ k ʏ r
mjóifjörður	m j ɔː u ɪ f j œ r ð ʏ r
mjókkandi	m j ɔ u h k a n t ɪ
mjólkurafurðir	m j ɔ u l̥ k ʏ r aː v ʏ r ð ɪ r
mjólkurbúunum	m j ɔ u l̥ k ʏ r̥ p uː ɔ n ʏ m
mjólkurdufti	m j ɔ u l̥ k ʏ r̥ t ʏ f t ɪ
mjólkurfernum	m j ɔ u l̥ k ʏ r̥ f ɛ r t n ʏ m
mjólkurframleiðslunni	m j ɔ u l̥ k ʏ r̥ f r a m l ɛ j ð s t l ʏ n ɪ
mjólkurframleiðslunni	m j ɔ u l̥ k ʏ r̥ f r a m l ɛ j ð s t l ʏ n ɪ
mjólkurhúss	m j ɔ u l̥ k ʏ r̥ h u s
mjólkurhvíta	m j ɔ u l̥ k ʏ r̥ kʰ v i t a
mjólkurkex	m j ɔ u l̥ k ʏ r̥ cʰ ɛ k s
mjólkurkú	m j ɔ u l̥ k ʏ r̥ kʰ uː
mjólkurkúa	m j ɔ u l̥ k ʏ r̥ kʰ uː a
mjólkurkýr	m j ɔ u l̥ k ʏ r̥ kʰ iː r
mjólkurmyndun	m j ɔ u l̥ k ʏ r m ɪ n t ʏ n
mjólkurmyndunar	m j ɔ u l̥ k ʏ r m ɪ n t ʏ n a r
mjólkurstöð	m j ɔ u l̥ k ʏ r̥ s t œː ð
mjólkursykur	m j ɔ u l̥ k ʏ r̥ s ɪː k ʏ r
mjólkursýra	m j ɔ u l̥ k ʏ r̥ s iː r a
mjólkurvinnslu	m j ɔ u l̥ k ʏ r v ɪ n s t l ʏ
mjóstur	m j ɔ u s t ʏ r
moðhausum	m ɔː ð h œ j s ʏ m
morgundaginn	m ɔ r k ʏ n t aː j ɪ n
mormónatrúar	m ɔ r m ɔ u n a tʰ r uː a r
músagildru	m uː s a c ɪ l t r ʏ
myndaleit	m ɪ n t a l ɛː j t
myndbreytast	m ɪ n t p r ɛ j t a s t
myndbreyttan	m ɪ n t p r ɛ j h t a n
myndefnaveitu	m ɪ n t ɛ p n a v ɛː j t ʏ
myndgreining	m ɪ n t k r ɛ j n i ŋ k
myndgreiningu	m ɪ n t k r ɛ j n i ŋ k ʏ
myndleysu	m ɪ n t l ɛː j s ʏ
myndrænar	m ɪ n t r a j n a r
myndrænu	m ɪ n t r a j n ʏ
myndskreyttar	m ɪ n t s k r ɛ j h t a r
myrkheima	m ɪ r̥ k h ɛ j m a
naflastrengjum	n a p l a s t r ɛ j ɲ c ʏ m
nafnbótinni	n a p n̥ p ɔ u t ɪ n ɪ
nafnhætti	n a p n̥ h a j h t ɪ
naglhreinsa	n a k l̥ r̥ ɛ j n s a
nammieitrun	n a m ɪ ɛː j t r ʏ n
nankinefni	n a ɲ̊ c ɪ n ɛ p n ɪ
nató	n aː t ɔ u
nauðgar	n œ j ð k a r
nauðsynlegustu	n œ j ð s ɪ n l ɛː ɣ ʏ s t ʏ
nauðugum	n œː j ð ʏ ɣ ʏ m
nauðungarsölu	n œː j ð u ŋ k a r̥ s œː l ʏ
nausti	n œ j s t ɪ
nautabala	n œː j t a p aː l a
nautabein	n œː j t a p ɛː j n
nautabein	n œː j t a p ɛː j n
nautafille	n œː j t a f ɪ l ɛ
nautahakk	n œː j t a h a h k
nautahakki	n œː j t a h a h c ɪ
nautakjöts	n œː j t a cʰ œ t s
nautaskankar	n œː j t a s k au ŋ̊ k a r
nautgripir	n œː j t k r ɪ p ɪ r
nauthvelið	n œː j t kʰ v ɛ l ɪ ð
nautin	n œː j t ɪ n
nautnalandi	n œ j h t n a l a n t ɪ
navahó	n aː v a h ɔ u
neðangreinda	n ɛː ð a n k r ɛ j n t a
neðangreinda	n ɛː ð a n k r ɛ j n t a
neðanmálsgreinum	n ɛː ð a n m au l s k r ɛː j n ʏ m
nefndasæti	n ɛ m t a s aː j t ɪ
nemendabókinni	n ɛː m ɛ n t a p ɔː u c ɪ n ɪ
nemendahópnum	n ɛː m ɛ n t a h ɔ u h p n ʏ m
nemendastólar	n ɛː m ɛ n t a s t ɔː u l a r
neskaupsstað	n ɛː s kʰ œ j f s t a ð
netdeild	n ɛː t ɛ j l t
netföng	n ɛː t f œ j ŋ k
netheimum	n ɛː t h ɛ j m ʏ m
nethópvinnu	n ɛː t h ɔ u p v ɪ n ʏ
netjubólgu	n ɛː t j ʏ p ɔ u l k ʏ
netlausa	n ɛː t l œ j s a
netleik	n ɛː t l ɛ j k
netleysið	n ɛː t l ɛ j s ɪ ð
neyðarathvarfsins	n ɛː j ð a r aː t kʰ v a r v s ɪ n s
neyðarathvörf	n ɛː j ð a r aː t kʰ v œ r v
neyðarhnappur	n ɛː j ð a r n̥ a h p ʏ r
neyðarlækkun	n ɛː j ð a r l a j h k ʏ n
neyðarlækkun	n ɛː j ð a r l a j h k ʏ n
neysluhyggju	n ɛ j s t l ʏ h ɪ c ʏ
neyslutækjum	n ɛ j s t l ʏ tʰ aː j c ʏ m
neyslutækjum	n ɛ j s t l ʏ tʰ aː j c ʏ m
neysluvatn	n ɛ j s t l ʏ v a h t n̥
neysluvenjum	n ɛ j s t l ʏ v ɛ n j ʏ m
niðurdælingarvatnið	n ɪː ð ʏ r̥ t aː j l i ŋ k a r v a h t n ɪ ð
niðurgreiðslum	n ɪː ð ʏ r̥ k r ɛ j ð s t l ʏ m
niðurlægingunni	n ɪː ð ʏ r l a j i ŋ k ʏ n ɪ
niðursveigðar	n ɪː ð ʏ r̥ s v ɛ j ɣ ð a r
niðursveigt	n ɪː ð ʏ r̥ s v ɛ j x t
niflheim	n ɪ p l h ɛ j m
nifteind	n ɪ f t ɛ j n t
nifteindastjörnu	n ɪ f t ɛ j n t a s t j œ r t n ʏ
nikulásdóttir	n ɪː k ʏ l au s t ɔ u h t ɪ r
nintendó	n ɪ n t ɛ n t ɔ u
nituráburður	n ɪː t ʏ r aː u p ʏ r ð ʏ r
norðangjólan	n ɔ r ð a n c ɔː u l a n
norðangjólan	n ɔ r ð a n c ɔː u l a n
norðaustlæga	n ɔ r ð œ j s t l a j ɣ a
norðaustlæga	n ɔ r ð œ j s t l a j ɣ a
norðausturhlutana	n ɔ r ð œ j s t ʏ r̥ l̥ ʏː t a n a
norðausturhorn	n ɔ r ð œ j s t ʏ r̥ h ɔ t n̥
norðausturkjördæmi	n ɔ r ð œ j s t ʏ r̥ cʰ œ r t a j m ɪ
norðausturkjördæmi	n ɔ r ð œ j s t ʏ r̥ cʰ œ r t a j m ɪ
norðlingafljóti	n ɔ r ð l i ŋ k a f l j ɔː u t ɪ
norðureyju	n ɔ r ð ʏ r ɛː j ʏ
norðurheimskautinu	n ɔ r ð ʏ r̥ h ɛ j m s k œ j t ɪ n ʏ
norðurheimskautinu	n ɔ r ð ʏ r̥ h ɛ j m s k œ j t ɪ n ʏ
norðurlandameistara	n ɔ r ð ʏ r l a n t a m ɛ j s t a r a
norðurlandameistarans	n ɔ r ð ʏ r l a n t a m ɛ j s t a r a n s
norðurlandameistari	n ɔ r ð ʏ r l a n t a m ɛ j s t a r ɪ
norðurlandsdeild	n ɔ r ð ʏ r l a n t s t ɛ j l t
norðurlandsdeildar	n ɔ r ð ʏ r l a n t s t ɛ j l t a r
norðurljósunum	n ɔ r ð ʏ r l j ɔː u s ɔ n ʏ m
norðurmjólk	n ɔ r ð ʏ r m j ɔ u l̥ k
norðurpólhettunni	n ɔ r ð ʏ r̥ pʰ ɔ u l h ɛ h t ʏ n ɪ
norðurskógar	n ɔ r ð ʏ r̥ s k ɔː u a r
norðursvæðisins	n ɔ r ð ʏ r̥ s v a j ð ɪ s ɪ n s
norræns	n ɔ r a j n s
notendahópur	n ɔː t ɛ n t a h ɔː u p ʏ r
notendamóttakaranum	n ɔː t ɛ n t a m ɔː u tʰ a k a r a n ʏ m
nothæfni	n ɔː t h a j p n ɪ
nothæfum	n ɔː t h a j v ʏ m
notkunarleiðbeiningum	n ɔː t k ʏ n a r l ɛ j ð p ɛ j n i ŋ k ʏ m
notkunarmöguleika	n ɔː t k ʏ n a r m œː ɣ ʏ l ɛ j k a
notkunarmöguleikum	n ɔː t k ʏ n a r m œː ɣ ʏ l ɛ j k ʏ m
nuddtækni	n ʏ tʰ a j h k n ɪ
nunnuklaustri	n ʏ n ʏ kʰ l œ j s t r ɪ
nytsemdarsjónarmið	n ɪː t s ɛ m t a r̥ s j ɔː u n a r m ɪ ð
næturlangt	n aiː t ʏ r l a ŋ̊ t
ofangreind	ɔː v a n k r ei n t
ofangreinda	ɔː v a n k r ei n t a
ofangreindan	ɔː v a n k r ɛ j n t a n
ofangreindan	ɔː v a n k r ɛ j n t a n
ofangreindar	ɔː v a n k r ei n t a r
ofangreindra	ɔː v a n k r ei n t r a
ofangreindri	ɔː v a n k r ei n t r ɪ
ofangreindu	ɔː v a n k r ei n t ʏ
ofangreindum	ɔː v a n k r ei n t ʏ m
ofangreint	ɔː v a n k r ei n̥ t
ofbeldishneigð	ɔ v p ɛ l t ɪ s n̥ ɛ j ɣ ð
offeitra	ɔ f ɛ j t r a
offramleiðslan	ɔ f r a m l ɛ j ð s t l a n
offramleiðslu	ɔ f r a m l ɛ j ð s t l ʏ
ofkældum	ɔ v cʰ a j l t ʏ m
ofneyslu	ɔ v n ɛ j s t l ʏ
ofnsteikt	ɔ p s t ɛ j x t
ofnsteiktur	ɔ p s t ɛ j x t ʏ r
ofurlaunin	ɔː v ʏ r l œː j n ɪ n
olíuafgreiðsla	ɔː l i j ʏ a v k r ɛ j ð s t l a
olíudreifingu	ɔː l i j ʏ t r ɛː j v i ŋ k ʏ
olíuhreinsun	ɔː l i j ʏ r̥ ɛ j n s ʏ n
olíuhreinsunarstöðvarinnar	ɔː l i j ʏ r̥ ɛ j n s ʏ n a r̥ s t œ ð v a r ɪ n a r
olíuleiðslurnar	ɔː l i j ʏ l ɛ j ð s t l ʏ t n a r
olíuleifum	ɔː l i j ʏ l ɛː j v ʏ m
olíumengunar	ɔː l i j ʏ m ɛ j ŋ k ʏ n a r
olíusvæðinu	ɔː l i j ʏ s v aː j ð ɪ n ʏ
opinská	ɔː p ɪ n s k aː u
orðabókanotkun	ɔ r ð a p ɔ u k a n ɔː t k ʏ n
orðabókin	ɔ r ð a p ɔː u c ɪ n
orðatiltækjum	ɔ r ð a tʰ ɪ l tʰ a j c ʏ m
orðhlutauppflettingar	ɔ r ð l̥ ʏ t a ʏ h p f l ɛ h t i ŋ k a r
orðuveiting	ɔ r ð ʏ v ɛː j t i ŋ k
orgeltónlist	ɔ r k ɛ l̥ tʰ ɔ u n l ɪ s t
orkneyjum	ɔ r̥ k n ɛ j ʏ m
orkubókhald	ɔ r̥ k ʏ p ɔː u k h a l t
orkugeirans	ɔ r̥ k ʏ c ɛː j r a n s
orkujafnvægi	ɔ r̥ k ʏ j a p v a j ɪ
orkusóunar	ɔ r̥ k ʏ s ɔː u ʏ n a r
orkuveitur	ɔ r̥ k ʏ v ɛː j t ʏ r
ormagöng	ɔ r m a k œ j ŋ k
ormsdóttir	ɔ r m s t ɔ u h t ɪ r
ostaveisla	ɔ s t a v ɛ j s t l a
ostrusósu	ɔ s t r ʏ s ɔː u s ʏ
ottó	ɔ h t ɔ u
óalandi	ɔː u a l a n t ɪ
óbeisluð	ɔː u p ɛ j s t l ʏ ð
óbeisluð	ɔː u p ɛ j s t l ʏ ð
óborganlegur	ɔː u p ɔ r k a n l ɛ ɣ ʏ r
ódrjúgsháls	ɔː u t r j u x s h au l s
ódæðisverk	ouː t a ð ɪ s v ɛ r̥ k
ófaglærðra	ɔː u f a ɣ l a j r ð r a
ófaglærðra	ɔː u f a ɣ l a j r ð r a
óforbetranlegur	ɔː u f ɔ r p ɛ t r a n l ɛ ɣ ʏ r
ógjarn	ɔː u c a t n̥
ógnvænlegri	ɔ u k n v a j n l ɛ ɣ r ɪ
ógnvænlegri	ɔ u k n v a j n l ɛ ɣ r ɪ
óheftur	ɔː u h ɛ f t ʏ r
óhegnt	ɔː u h ɛ x ŋ̊ t
óhlutbundinni	ɔː u l̥ ʏ t p ʏ n t ɪ n ɪ
óhrjálegar	ɔː u r̥ j au l ɛː ɣ a r
ókey	ɔː u kʰ ɛː j
ókey	ɔː u kʰ ɛː j
ókrýndur	ɔː u kʰ r i n t ʏ r
ólafssúran	ɔː u l a f s uː r a n
ólafsvíkinga	ɔː u l a v s v i c i ŋ k a
ólafsvíkurkirkju	ɔː u l a f s v iː k ʏ r cʰ ɪ r̥ c ʏ
óliver	ɔː u l ɪ v ɛ r
ólsen	ɔ u l s ɛ n
ólympíugreinum	ɔː u l ɪ m p i j ʏ k r ɛː j n ʏ m
ólympíugreinum	ɔː u l ɪ m p i j ʏ k r ɛː j n ʏ m
ólympíunefndarinnar	ɔː u l ɪ m p i j ʏ n ɛ m t a r ɪ n a r
ólympíusamband	ɔː u l ɪ m p i j ʏ s a m p a n t
ómtæki	ɔː u m tʰ a j c ɪ
ómtæki	ɔː u m tʰ a j c ɪ
ónyx	ɔː u n ɪ k s
óperusöngvararnir	ɔː u p ɛ r ʏ s œ j ŋ k v a r a t n ɪ r
óperusöngvararnir	ɔː u p ɛ r ʏ s œ j ŋ k v a r a t n ɪ r
ópuskerfin	ɔː u p ʏ s cʰ ɛ r v ɪ n
órafmögnuð	ɔː u r a v m œ k n ʏ ð
órangúta	ɔː u r a ŋ k uː t a
órangúta	ɔː u r a ŋ k uː t a
órans	ɔː u r a n s
óravíddum	ɔː u r a v i t ʏ m
óráðshjal	ɔː u r au ð s ç aː l
óreganó	ɔː u r ɛ k aː n ɔ u
óreglusömu	ɔː u r ɛ k l ʏ s œː m ʏ
óreiðuverkefni	ɔː u r ɛ j ð ʏ v ɛ r̥ k ɛ p n ɪ
óreiðuverkefni	ɔː u r ɛ j ð ʏ v ɛ r̥ k ɛ p n ɪ
óréttmætu	ɔː u r j ɛ h t m a j t ʏ
óréttmætu	ɔː u r j ɛ h t m a j t ʏ
óríon	ɔː u r i ɔ n
óróanum	ɔː u r ɔ u a n ʏ m
órökstuddum	ɔː u r œ k s t ʏ t ʏ m
ósamfasa	ɔː u s a m f a s a
óshlíð	ɔː u s l̥ i ð
óskaveislustjóri	ɔ u s k a v ɛ j s t l ʏ s t j ɔː u r ɪ
óskaveislustjóri	ɔ u s k a v ɛ j s t l ʏ s t j ɔː u r ɪ
óskurum	ɔ u s k ʏ r ʏ m
ósnortinni	ɔː u s t n ɔ r̥ t ɪ n ɪ
ósnöfurmannlegt	ɔː u s t n œ v ʏ r m a n l ɛ x t
ósonlagið	ɔː u s ɔ n l a j ɪ ð
ósonlagið	ɔː u s ɔ n l a j ɪ ð
ósvífni	ɔː u s v i p n ɪ
ósvífursdóttur	ɔː u s v i v ʏ r̥ s t ɔ u h t ʏ r
óttafullir	ɔ u h t a f ʏ t l ɪ r
óttalausir	ɔ u h t a l œː j s ɪ r
óttalausir	ɔ u h t a l œː j s ɪ r
óttalegt	ɔ u h t a l ɛ x t
óttarsstaðavör	ɔ u h t a r̥ s t a ð a v œː r
óumdeilanlegum	ɔː u ʏ m t ɛ j l a n l ɛː ɣ ʏ m
óumdeilanlegum	ɔː u ʏ m t ɛ j l a n l ɛː ɣ ʏ m
óviðráðanlegum	ɔː u v ɪ ð r au ð a n l ɛː ɣ ʏ m
óvinaher	ɔː u v ɪ n a h ɛː r
óvissuferðina	ɔː u v ɪ s ʏ f ɛ r ð ɪ n a
pakkningarstærð	pʰ a h k n i ŋ k a r̥ s t a j r ð
pappírsfyrirtækið	pʰ a h p i r̥ s f ɪ r ɪ r tʰ aː j c ɪ ð
pappírsmaukið	pʰ a h p i r̥ s m œː j c ɪ ð
papæja	pʰ aː p a j a
parkinsonsveiki	pʰ a r̥ c ɪ n s ɔ n s v ɛː j c ɪ
peningamillifærslur	pʰ ɛː n i ŋ k a m ɪ t l ɪ f a j r̥ s t l ʏ r
peningasóun	pʰ ɛː n i ŋ k a s ɔː u ʏ n
peningaupphæð	p ɛː n i ŋ k a ʏ h p h ai ð
persónuafsláttinn	pʰ ɛ r̥ s ɔ u n ʏ a f s t l au h t ɪ n
persónueiginleikar	pʰ ɛ r̥ s ɔ u n ʏ ɛː j ɪ n l ɛ j k a r
persónueiginleikar	pʰ ɛ r̥ s ɔ u n ʏ ɛː j ɪ n l ɛ j k a r
persónuleikans	pʰ ɛ r̥ s ɔ u n ʏ l ɛː j k a n s
persónuleikans	pʰ ɛ r̥ s ɔ u n ʏ l ɛː j k a n s
persónuleikaprófið	pʰ ɛ r̥ s ɔ u n ʏ l ɛ j k a p r ɔː u ɪ ð
persónuleikaprófið	pʰ ɛ r̥ s ɔ u n ʏ l ɛ j k a p r ɔː u ɪ ð
perumaukið	pʰ ɛː r ʏ m œː j c ɪ ð
peysum	pʰ ɛː j s ʏ m
piparsósu	pʰ ɪː p a r s ɔː u s ʏ
pjönkur	p j œ ŋ̊ k ʏ r
pjönkur	p j œ ŋ k ʏ r
planka	p l a ŋ̊ k a
plasmaúthreinsun	pʰ l a s m aː u t r̥ ɛ j n s ʏ n
plastjólasveina	pʰ l a s t j ɔ u l a s v ɛː j n a
plastjólasveina	pʰ l a s t j ɔ u l a s v ɛː j n a
plastmótunar	pʰ l a s t m ɔ u t ʏ n a r
plaststrengur	pʰ l a s t s t r ɛ j ŋ k ʏ r
plágu	pʰ l aː u ʏ
plánetan	pʰ l aː u n ɛ t a n
plógar	pʰ l ɔː u a r
plómutré	pʰ l ɔː u m ʏ tʰ r j ɛː
plæging	pʰ l a j ɪ ŋ k
postulínskaupmaður	pʰ ɔ s t ʏ l i n s kʰ œ j h p m a ð ʏ r
pottbrauð	pʰ ɔ h t p r œ j ð
pranga	p r a ŋ k a
prenttæknistofnun	pʰ r ɛ n̥ tʰ a j h k n ɪ s t ɔ p n ʏ n
prentupplausn	pʰ r ɛ n̥ t ʏ h p l œ j s t n̥
prestabrá	pʰ r ɛ s t a p r aː u
prestslærða	pʰ r ɛ s t s l a j r ð a
prinsessukjólnum	pʰ r ɪ n s ɛ s ʏ cʰ ɔ u l n ʏ m
príongensins	pʰ r i n c ɛ n s ɪ n s
prjóngrindur	pʰ r j ɔː u n k r ɪ n t ʏ r
prjónlesi	pʰ r j ɔ u n l ɛ s ɪ
pró	pʰ r ɔː u
prófdagurinn	pʰ r ɔː u v t a ɣ ʏ r ɪ n
prófkjör	pʰ r ɔ u f cʰ œ r
prófkjöri	pʰ r ɔ u f cʰ œ r ɪ
prófkjörsreglur	pʰ r ɔ u f cʰ œ r̥ s r ɛ k l ʏ r
prófs	pʰ r ɔ u f s
prófsins	pʰ r ɔ u f s ɪ n s
prófstjóri	pʰ r ɔ u f s t j ɔ u r ɪ
prófsýning	pʰ r ɔ u f s i n i ŋ k
prófsýningu	pʰ r ɔ u f s i n i ŋ k ʏ
próftaki	pʰ r ɔ u f tʰ a c ɪ
próftitilinn	pʰ r ɔ u f tʰ ɪ t ɪ t l ɪ n
prófun	pʰ r ɔː u ʏ n
prófuninni	pʰ r ɔː u ʏ n ɪ n ɪ
prógramm	pʰ r ɔː u k r a m
própansýra	pʰ r ɔː u p a n s iː r a
prósenta	pʰ r ɔː u s ɛ n̥ t a
prósentu	pʰ r ɔː u s ɛ n̥ t ʏ
prósentum	pʰ r ɔː u s ɛ n̥ t ʏ m
prósentustigi	pʰ r ɔː u s ɛ n̥ t ʏ s t i j ɪ
prósentustigum	pʰ r ɔː u s ɛ n̥ t ʏ s t ɪː ɣ ʏ m
prósentutalan	pʰ r ɔː u s ɛ n̥ t ʏ tʰ aː l a n
próteingjafar	pʰ r ɔː u t ɛ j n c aː v a r
próteingjafar	pʰ r ɔː u t ɛ j n c aː v a r
próteinhlutanum	pʰ r ɔː u t ɛ j n l̥ ʏː t a n ʏ m
próteinhlutanum	pʰ r ɔː u t ɛ j n l̥ ʏː t a n ʏ m
próteinmagn	pʰ r ɔː u t ɛ j n m a k n̥
próteinmagn	pʰ r ɔː u t ɛ j n m a k n̥
prufuleikjum	pʰ r ʏː v ʏ l ɛː j c ʏ m
pulsubrauð	pʰ ʏ l s ʏ p r œː j ð
punktainneign	pʰ u ŋ̊ t a ɪ n ɛ j k n̥
pyangyong	pʰ ɪ au ŋ k ɪ ɔ ŋ k
radartækjum	r aː t a r tʰ aː j c ʏ m
rafeindasvæðin	r aː v ɛ j n t a s v aː j ð ɪ n
rafeindasvæðin	r aː v ɛ j n t a s v aː j ð ɪ n
rafgeyma	r a v c ɛ j m a
rafiðnaðarskólans	r aː v ɪ ð n a ð a r s k ɔː u l a n s
rafmagnsleysi	r a v m a k s l ɛː j s ɪ
rafmagnstengingu	r a v m a k s t ɛ j ɲ c i ŋ k ʏ
rafmagnstæki	r a v m a k s tʰ a j c ɪ
rafmagnsveiturnar	r a v m a k s v ɛː j t ʏ t n a r
rafnsdóttur	r a p s t ɔ u h t ʏ r
raforkuframleiðsla	r aː v ɔ r̥ k ʏ f r a m l ɛ j ð s t l a
rafrænan	r a v r a j n a n
rafstraum	r a f s t r œ j m
rafstraumur	r a f s t r œ j m ʏ r
raftónlistargaur	r a f tʰ ɔ u n l ɪ s t a r k œː j r
raftónlistargaur	r a f tʰ ɔ u n l ɪ s t a r k œː j r
raftæki	r a f tʰ a j c ɪ
raftækniráðsins	r a f tʰ a j h k n ɪ r au ð s ɪ n s
rafveitukerfi	r a v ɛ j t ʏ cʰ ɛ r v ɪ
rambó	r a m p ɔ u
ranga	r a ŋ k a
rangan	r a ŋ k a n
rangar	r a ŋ k a r
rangfærslur	r a ŋ k f ai r̥ s t l ʏ r
ranghugmyndir	r a ŋ k h ʏ ɣ m ɪ n t ɪ r
ranglaði	r a ŋ l a ð ɪ
ranglega	r a ŋ k l ɛ ɣ a
ranglæti	r a ŋ k l ai t ɪ
ranglætis	r au ŋ k l a j t ɪ s
rangri	r a ŋ k r ɪ
rangsælis	r a ŋ k s ai l ɪ s
rangt	r a ŋ̊ t
Rangæinga	r a ŋ k ai j i ŋ k a
ranka	r a ŋ̊ k a
rankað	r a ŋ̊ k a ð
rankaði	r a ŋ̊ k a ð ɪ
rannsóknanemi	r a n s ɔ u h k n a n ɛː m ɪ
rannsóknarathafnir	r a n s ɔ u h k n a r aː t a p n ɪ r
rannsóknarmanni	r a n s ɔ u h k n a r m a n ɪ
rannsóknarniðurstaðna	r a n s ɔ u h k n a r t n ɪː ð ʏ r s t a ð n a
rannsóknarsamstarfi	r a n s ɔ u h k n a r̥ s a m s t a r v ɪ
rannsóknarskips	r a n s ɔ u h k n a r̥ s c ɪ f s
rannsóknarstigi	r a n s ɔ u h k n a r̥ s t i j ɪ
rannsóknarverkefnum	r a n s ɔ u h k n a r v ɛ r̥ k ɛ p n ʏ m
rannsóknasamningur	r a n s ɔ u h k n a s a m n i ŋ k ʏ r
rannsóknaskip	r a n s ɔ u h k n a s c ɪː p
rannsóknastarfið	r a n s ɔ u h k n a s t a r v ɪ ð
rannsóknastofa	r a n s ɔ u h k n a s t ɔː v a
rannsóknastofnanir	r a n s ɔ u h k n a s t ɔ p n a n ɪ r
rannsóknaverkefninu	r a n s ɔ u h k n a v ɛ r̥ k ɛ p n ɪ n ʏ
rannveigardóttir	r a n v ɛ j ɣ a r t ɔ u h t ɪ r
rannveigardóttir	r a n v ɛ j ɣ a r t ɔ u h t ɪ r
ratleikur	r aː t l ɛ j k ʏ r
ratleikurinn	r aː t l ɛ j k ʏ r ɪ n
rauðbirkin	r œ j ð p ɪ r̥ c ɪ n
rauðbrystingur	r œ j ð p r ɪ s t i ŋ k ʏ r
rauðhetti	r œː j ð h ɛ h t ɪ
rauðhettureglunnar	r œː j ð h ɛ h t ʏ r ɛ k l ʏ n a r
rauðkornaþykknis	r œ j ð kʰ ɔ r t n a θ ɪ h k n ɪ s
rauðshelli	r œ j ð s h ɛ t l ɪ
raunarsaga	r œː j n a r s aː ɣ a
raunasaga	r œː j n a s aː ɣ a
raunfjölda	r œː j n f j œ l t a
raunhyggju	r œː j n h ɪ c ʏ
raunleiks	r œ j n l ɛ j k s
raunleiks	r œ j n l ɛ j k s
raunneyslu	r œ j n ɛ j s t l ʏ
raunneyslu	r œ j n ɛ j s t l ʏ
rauntíma	r œ j n tʰ i m a
raunverð	r œ j n v ɛ r ð
raunveruleikasjónvarp	r œ j n v ɛ r ʏ l ɛ j k a s j ɔ u n v a r̥ p
raunveruleikasjónvarp	r œ j n v ɛ r ʏ l ɛ j k a s j ɔ u n v a r̥ p
raunveruleikasjónvarp	r œ j n v ɛ r ʏ l ɛ j k a s j ɔ u n v a r̥ p
raunvöxtum	r œ j n v œ k s t ʏ m
ráðherrafunda	r aː u ð h ɛ r a f ʏ n t a
ráðherrafundinn	r aː u ð h ɛ r a f ʏ n t ɪ n
ráðherraskipuð	r aː u ð h ɛ r a s c ɪː p ʏ ð
ráðherrunum	r aː u ð h ɛ r ɔ n ʏ m
ráðstefnugrein	r au ð s t ɛ p n ʏ k r ɛː j n
ránmý	r aː u n m i
rásina	r aː u s ɪ n a
rásirnar	r aː u s ɪ t n a r
rásnúmer	r aː u s n u m ɛ r
ráspóllinn	r aː u s pʰ ɔ u t l ɪ n
ráspóllinn	r aː u s pʰ ɔ u t l ɪ n
ráspólnum	r aː u s pʰ ɔ u l n ʏ m
ráspólnum	r aː u s pʰ ɔ u l n ʏ m
reðursrætur	r ɛː ð ʏ r s r a j t ʏ r
refasveit	r ɛː v a s v ɛː j t
reglubókunum	r ɛ k l ʏ p ɔː u k ɔ n ʏ m
reglugerðarbreytingu	r ɛ k l ʏ c ɛ r ð a r p r ɛː j t i ŋ k ʏ
regnbogi	r ɛ k p ɔ j ɪ
regnboginn	r ɛ k p ɔ j ɪ n
regnskógarnir	r ɛ k s k ɔ u a t n ɪ r
reiðhjólavagnar	r ɛ j ð ç ɔ u l a v a k n a r
reiðhjólavagnar	r ɛ j ð ç ɔ u l a v a k n a r
reiðingsgras	r ɛː j ð i ŋ k s k r aː s
reiðtygi	r ɛ j ð t i j ɪ
reikimeistarar	r ɛː j c ɪ m ɛ j s t a r a r
reikisamninga	r ɛː j c ɪ s a m n i ŋ k a
reikistjörnum	r ɛː j c ɪ s t j œ r t n ʏ m
reikistjörnuna	r ɛː j c ɪ s t j œ r t n ʏ n a
reikistjörnunni	r ɛː j c ɪ s t j œ r t n ʏ n ɪ
reiknikúnstum	r ɛ j h k n ɪ k u n s t ʏ m
reikningseigenda	r ɛ j h k n i ŋ s ɛː j ɣ ɛ n t a
reikningsskila	r ɛ j h k n i ŋ s c ɪː l a
reikningsskilagúrúar	r ɛ j h k n i ŋ s c ɪ l a k uː r u a r
reikningsskilavenju	r ɛ j h k n i ŋ s c ɪː l a v ɛ n j ʏ
reiknireglur	r ɛ j h k n ɪ r ɛ k l ʏ r
reiknistofnun	r ɛ j h k n ɪ s t ɔ p n ʏ n
reiknistofu	r ɛ j h k n ɪ s t ɔː v ʏ
reimar	r ɛː j m a r
reimt	r ɛ j m̥ t
reinina	r ɛː j n ɪ n a
reitatalningar	r ɛː j t a tʰ a l n i ŋ k a r
reitina	r ɛː j t ɪ n a
rekstrareiningu	r ɛ k s t r a r ɛː j n i ŋ k ʏ
rekstrarfræðingur	r ɛ k s t r a r f r a j ð i ŋ k ʏ r
rekstrargreinar	r ɛ k s t r a r k r ɛː j n a r
rekstrarleigusamningi	r ɛ k s t r a r l ɛ j ɣ ʏ s a m n i ɲ c ɪ
rekstrarleyfis	r ɛ k s t r a r l ɛː j v ɪ s
rekstrarleyfishafa	r ɛ k s t r a r l ɛ j v ɪ s h aː v a
rekstrarreikningurinn	r ɛ k s t r a r ɛ j h k n i ŋ k ʏ r ɪ n
rekstrarstjóra	r ɛ k s t r a r̥ s t j ɔː u r a
Renault	r ʏː n ou
renaultbílsins	r ɛː n ou p i l s ɪ n s
rennibraut	r ɛ n ɪ p r œ j t
reyðarfjörður	r ɛː j ð a r f j œ r ð ʏ r
reyfið	r ɛː j v ɪ ð
reykfjallasósu	r ɛː j k f j a t l a s ɔː u s ʏ
reykfjallasósu	r ɛː j k f j a t l a s ɔː u s ʏ
reykháfa	r ɛː j k h au v a
reykhólahrepps	r ɛː j k h ɔ u l a r̥ ɛ h p s
reykhólahrepps	r ɛː j k h ɔ u l a r̥ ɛ h p s
reykingarfólk	r ɛː j c i ŋ k a r f ɔ u l̥ k
reykingarfólk	r ɛː j c i ŋ k a r f ɔ u l̥ k
reykingarmenn	r ɛː j c i ŋ k a r m ɛ n
reykjabyggð	r ɛː j c a p ɪ ɣ ð
reykjadalnum	r ɛː j c a t a l n ʏ m
reykjadalslækur	r ɛː j c a t a l s t l a j k ʏ r
reykjadalslækur	r ɛː j c a t a l s t l a j k ʏ r
reykjaréttir	r ɛː j c a r j ɛ h t ɪ r
reykjarvíkurborgar	r ɛː j c a r v i k ʏ r p ɔ r k a r
reykjasel	r ɛː j c a s ɛː l
reykjavíkurmaraþoninu	r ɛː j c a v i k ʏ r m aː r a θ ɔ n ɪ n ʏ
reykjavíkurmeistaratitilinn	r ɛː j c a v i k ʏ r m ɛ j s t a r a tʰ ɪː t ɪ t l ɪ n
reykjavíkurrisarnir	r ɛː j c a v i k ʏ r ɪː s a t n ɪ r
reyklausir	r ɛː j kʰ l œ j s ɪ r
reyklausir	r ɛː j kʰ l œ j s ɪ r
reyksalur	r ɛː j k s a l ʏ r
reykstaður	r ɛː j k s t a ð ʏ r
reykstofu	r ɛː j k s t ɔ v ʏ
reynslukennslu	r ɛ j n s t l ʏ cʰ ɛ n s t l ʏ
reynslutímanum	r ɛ j n s t l ʏ tʰ iː m a n ʏ m
réttargæslumanns	r j ɛ h t a r̥ c a j s t l ʏ m a n s
réttdræpur	r j ɛ h t r a j p ʏ r
réttindagæslu	r j ɛ h t ɪ n t a c a j s t l ʏ
réttindahópa	r j ɛ h t ɪ n t a h ɔː u p a
réttsælis	r j ɛ h t s a j l ɪ s
rimlagólf	r ɪ m l a k ɔ u l v
risafrumuæðabólgu	r ɪː s a f r ʏ m ʏ a j ð a p ɔ u l k ʏ
risafrumuæðabólgu	r ɪː s a f r ʏ m ʏ a j ð a p ɔ u l k ʏ
risafyrirtækinu	r ɪː s a f ɪ r ɪ r tʰ aː j c ɪ n ʏ
risaskjá	r ɪː s a s c aː u
risatónleikar	r ɪː s a tʰ ɔ u n l ɛ j k a r
risatónleikar	r ɪː s a tʰ ɔ u n l ɛ j k a r
ritdómendur	r ɪː t ɔ u m ɛ n t ʏ r
ritgerðasveifina	r ɪː t c ɛ r ð a s v ɛː j v ɪ n a
rithætti	r ɪː t h a j h t ɪ
ritningargreinar	r ɪ h t n i ŋ k a r k r ɛː j n a r
ritstjórnargreininni	r ɪː t s t j ɔ u r t n a r k r ɛ j n ɪ n ɪ
ritstjórnargreininni	r ɪː t s t j ɔ u r t n a r k r ɛ j n ɪ n ɪ
ritstjórnarmeðlimir	r ɪː t s t j ɔ u r t n a r m ɛ ð l ɪ m ɪ r
ríkisframkvæmdir	r iː c ɪ s f r a m kʰ v a j m t ɪ r
ríkisstjórnarflokka	r iː c ɪ s t j ɔ u r t n a r̥ f l ɔ h k a
rjómanum	r j ɔː u m a n ʏ m
rjómaost	r j ɔː u m a ɔ s t
rjómaskyr	r j ɔː u m a s c ɪː r
rjómatoppur	r j ɔː u m a tʰ ɔ h p ʏ r
rjúpnaumræðurnar	r j u h p n a ʏ m r a j ð ʏ t n a r
rjúpnaumræðurnar	r j u h p n a ʏ m r a j ð ʏ t n a r
rokkbænum	r ɔ h k p a j n ʏ m
rottagöngurnar	r ɔ h t a k œ j ŋ k ʏ r t n a r
rottusönginn	r ɔ h t ʏ s œ j ɲ c ɪ n
róbertssyni	r ɔː u p ɛ r̥ t s ɪː n ɪ
rófa	r ɔː u a
rófubeininu	r ɔː u ʏ p ɛː j n ɪ n ʏ
rófubeininu	r ɔː u ʏ p ɛː j n ɪ n ʏ
rólegheitin	r ɔː u l ɛ ɣ h ɛː j t ɪ n
rólegheitin	r ɔː u l ɛ ɣ h ɛː j t ɪ n
rólegi	r ɔː u l ɛ j ɪ
rómantíkur	r ɔː u m a n tʰ iː k ʏ r
rómantískir	r ɔː u m a n tʰ i s c ɪ r
rómverskar	r ɔ u m v ɛ r̥ s k a r
rósadal	r ɔː u s a t a l
rósamunn	r ɔː u s a m ʏ n
rósaroða	r ɔː u s a r ɔː ð a
rósarsdóttir	r ɔː u s a r̥ s t ɔ u h t ɪ r
rósarunn	r ɔː u s a r ʏ n
rósmarínsósu	r ɔː u s m a r i n s ɔː u s ʏ
rósmundardóttir	r ɔː u s m ʏ n t a r t ɔ u h t ɪ r
rósviður	r ɔː u s v ɪ ð ʏ r
rótargrænmeti	r ɔː u t a r k r a j m ɛ t ɪ
rótargrænmeti	r ɔː u t a r k r a j m ɛ t ɪ
rótarhnyðjur	r ɔː u t a r n̥ ɪ ð j ʏ r
rótarjöklum	r ɔː u t a r j œ h k l ʏ m
rótarstúfur	r ɔː u t a r s t uː v ʏ r
runólfsdóttur	r ʏː n ɔ u l s t ɔ u h t ʏ r
ruslpósti	r ʏ s t l pʰ ɔ u s t ɪ
rúghveiti	r u x kʰ v ɛ j t ɪ
rúmstólpa	r u m s t ɔ u l̥ p a
rústasvæðisins	r u s t a s v a j ð ɪ s ɪ n s
ryksogi	r ɪː k s ɔ j ɪ
ryksuguhaus	r ɪː k s ʏ ɣ ʏ h œː j s
ræðarinn	r aː j ð a r ɪ n
ræðukeppni	r aː j ð ʏ cʰ ɛ h p n ɪ
ræðulið	r aː j ð ʏ l ɪː ð
ræðupúlt	r aː j ð ʏ pʰ u l̥ t
rækjubragð	r aː j c ʏ p r a ɣ ð
rækjufrystitogara	r aː j c ʏ f r ɪ s t ɪ tʰ ɔː ɣ a r a
rækjukvóta	r aː j c ʏ kʰ v ɔː u t a
rækjukvóta	r aː j c ʏ kʰ v ɔː u t a
rækjutogara	r aː j c ʏ tʰ ɔː ɣ a r a
rækjutroll	r aː j c ʏ tʰ r ɔ l
rækjuveiðar	r aː j c ʏ v ɛː j ð a r
rækjuveiðar	r aː j c ʏ v ɛː j ð a r
rækjuverksmiðju	r aː j c ʏ v ɛ r̥ k s m ɪ ð j ʏ
rækjuverksmiðjunni	r aː j c ʏ v ɛ r̥ k s m ɪ ð j ʏ n ɪ
rækjuvinnsla	r aː j c ʏ v ɪ n s t l a
rækjuvinnslunum	r aː j c ʏ v ɪ n s t l ɔ n ʏ m
ræktanda	r a j x t a n t a
ræktanlegu	r a j x t a n l ɛː ɣ ʏ
ræktina	r a j x t ɪ n a
ræktunarinnar	r a j x t ʏ n a r ɪ n a r
ræktunarsögu	r a j x t ʏ n a r s œː ɣ ʏ
ræsiborðanum	r aː j s ɪ p ɔ r ð a n ʏ m
ræsibúnaðurinn	r aː j s ɪ p uː n a ð ʏ r ɪ n
ræstingarfyrirtækið	r a j s t i ŋ k a r f ɪː r ɪ r̥ tʰ a j c ɪ ð
ræstingarvara	r a j s t i ŋ k a v aː r a
ræstingu	r a j s t i ŋ k ʏ
rökfræðikúrs	r œː k f r a j ð ɪ k u r̥ s
rökfræðikúrsinn	r œː k f r a j ð ɪ k u r̥ s ɪ n
rökfræðilegu	r œː k f r a j ð ɪ l ɛː ɣ ʏ
rökgreiningarheimspeki	r œ k r ɛ j n i ŋ k a r̥ h ɛ j m s p ɛ c ɪ
rökræðueinvígi	r œː k r a j ð ʏ ɛ j n v i j ɪ
rökræðueinvígi	r œː k r a j ð ʏ ɛ j n v i j ɪ
rökræðukeppni	r œː k r a j ð ʏ cʰ ɛ h p n ɪ
röngum	r œ ɲ k ʏ m
röntgendeildinni	r œ n̥ t k ɛ n t ɛ j l t ɪ n ɪ
röntgentæki	r œ n̥ t k ɛ n tʰ a j c ɪ
safndeild	s a p n̥ t ɛ j l t
sagnfræðilegu	s a k n̥ f r a j ð ɪ l ɛː ɣ ʏ
sakleysingjanna	s aː k l ɛ j s i ɲ c a n a
salsasósu	s a l s a s ɔː u s ʏ
saltsteinum	s a l̥ t s t ɛ j n ʏ m
samanburðareinstaklinga	s aː m a n p ʏ r ð a r ɛ j n s t a h k l i ŋ k a
samankomið	s aː m a n k ɔ m ɪ ð
samankomin	s aː m a n k ɔː m ɪ n
samankomnir	s aː m a n k ɔ m n ɪ r
sambandsstjórn	s a m p a n t s t j ɔ u r t n̥
sambó	s a m p ɔ u
sameiginlegir	s aː m ɛ j ɪ n l ɛ j ɪ r
sameindin	s aː m ɛ j n t ɪ n
sameindum	s aː m ɛ j n t ʏ m
sameiningarhallarinnar	s aː m ɛ j n i ŋ k a r h a t l a r ɪ n a r
sameiningarhugmyndin	s aː m ɛ j n i ŋ k a r h ʏ ɣ m ɪ n t ɪ n
samevrópska	s aː m ɛ v r ɔ u p s k a
samfélagsgreinar	s a m f j ɛ l a k s k r ɛː j n a r
samfélagsgreinum	s a m f j ɛ l a k s k r ɛː j n ʏ m
samhljóð	s a m l̥ j ɔ u ð
samhljóðakerfinu	s a m l̥ j ɔ u ð a cʰ ɛ r v ɪ n ʏ
samhljómi	s a m l̥ j ɔ u m ɪ
samhæfingarsveitar	s aː m h a j v i ŋ k a r s v ɛː j t a r
samhæfingarsveitar	s aː m h a j v i ŋ k a r s v ɛː j t a r
samkeppnishæfa	s a m cʰ ɛ h p n ɪ s h a j v a
samlagið	s a m l a j ɪ ð
samlokueiningum	s a m l ɔ k ʏ ɛ j n i ŋ k ʏ m
samlæsingar	s a m l a j s i ŋ k a r
samningaviðræðunum	s a m n i ŋ k a v ɪ ð r a j ð ɔ n ʏ m
samningseyðublað	s a m n i ŋ s ɛ j ð ʏ p l aː ð
samningsupphæðin	s a m n i ŋ s ʏ h p h a j ð ɪ n
samnorrænnar	s a m n ɔ r a j t n a r
samnorrænt	s a m n ɔ r a j n̥ t
samnorrænum	s a m n ɔ r a j n ʏ m
samprófun	s a m pʰ r ɔ u ʏ n
samráðshópsins	s a m r au ð s h ɔ u p s ɪ n s
samrunapróteinum	s a m r ʏ n a pʰ r ɔː u t ɛ j n ʏ m
samrunapróteinum	s a m r ʏ n a pʰ r ɔː u t ɛ j n ʏ m
samræmast	s a m r a j m a s t
samræming	s a m r a j m i ŋ k
samræmir	s a m r a j m ɪ r
samstarfsfyrirtæki	s a m s t a r s f ɪ r ɪ r tʰ aː j c ɪ
samstarfslæknar	s a m s t a r s l a j h k n a r
samsteypu	s a m s t ɛ j p ʏ
samtenginga	s a m tʰ ɛ j ɲ c i ŋ k a
samtryggingardeildar	s a m tʰ r ɪ c i ŋ k a r t ɛ j l t a r
sandbogi	s a n t p ɔ j ɪ
sandsteinn	s a n t s t ɛ j t n̥
sannleiksleitin	s a n l ɛ j k s t l ɛː j t ɪ n
sannreynd	s a n r ɛ j n t
santíagó	s a n t i j aː k ɔ u
sauðanesi	s œː j ð a n ɛː s ɪ
sauðar	s œː j ð a r
sauðarhúsi	s œː j ð a r h uː s ɪ
sauðfjárbeit	s œ j ð f j au r p ɛ j t
sauðfjárbeit	s œ j ð f j au r p ɛ j t
sauðfjárbú	s œ j ð f j au r p u
sauðfjárbúa	s œ j ð f j au r p uː a
sauðfjárböð	s œ j ð f j au r p œ ð
sauðfjárslátrun	s œ j ð f j au r̥ s t l aː u t r ʏ n
sauðkindar	s œ j ð cʰ ɪ n t a r
saumó	s œ j m ɔ u
saumó	s œ j m ɔ u
sauratinda	s œː j r a tʰ ɪ n t a
sauratindum	s œː j r a tʰ ɪ n t ʏ m
seðlabanka	s ɛ ð l a p a ŋ̊ k a
seðlabankann	s ɛ ð l a p a ŋ̊ k a n
seðlabankans	s ɛ ð l a p a ŋ̊ k a n s
seðlabankanum	s ɛ ð l a p a ŋ̊ k a n ʏ m
seðlabankastjóra	s ɛ ð l a p a ŋ̊ k a s t j ouː r a
seðlabankastjóri	s ɛ ð l a p a ŋ̊ k a s t j ouː r ɪ
seðlabanki	s ɛ ð l a p a ɲ̊ c c ɪ
seðlabankinn	s ɛ ð l a p a ɲ̊ c ɪ n
segulsviðsbreytinga	s ɛː ɣ ʏ l s v ɪ ð s p r ɛː j t i ŋ k a
seiðaskiljur	s ɛː j ð a s c ɪ l j ʏ r
seiðing	s ɛː j ð i ŋ k
seigjustigi	s ɛː j ʏ s t i j ɪ
seigustu	s ɛː j ɣ ʏ s t ʏ
seinniparturinn	s ɛ j t n ɪ pʰ a r̥ t ʏ r ɪ n
seleyri	s ɛː l ɛ j r ɪ
sellóin	s ɛ l ɔ u ɪ n
sellulósi	s ɛ l ʏ l ɔː u s ɪ
seltjarnarneskaupstaðar	s ɛ l tʰ j a r t n a r n ɛ s kʰ œ j f s t a ð a r
selveiðimenn	s ɛ l v ɛ j ð ɪ m ɛ n
Selvogi	s ɛ l v ɔː j ɪ
Selvogi	s ɛ l v ɔ j ɪ
sesamfræ	s ɛː s a m f r a j
sesseljuheimilis	s ɛ s ɛ l j ʏ h ɛ j m ɪ l ɪ s
setbergshnaus	s ɛː t p ɛ r k s n̥ œ j s
seyta	s ɛː j t a
Shanghai	s j a ŋ h ai
shellmóti	s j ɛ l m ɔ u t ɪ
siðameistara	s ɪː ð a m ɛ j s t a r a
sigbjörnsdóttur	s ɪ ɣ p j œ r̥ s t ɔ u h t ʏ r
sigurrósu	s ɪː ɣ ʏ r ɔː u s ʏ
silfurdoppótt	s ɪ l v ʏ r̥ t ɔ h p ɔ u h t
silfursjóður	s ɪ l v ʏ r̥ s j ɔː u ð ʏ r
silfurskeiðina	s ɪ l v ʏ r̥ s c ɛː j ð ɪ n a
silungsveiðivon	s ɪː l u ŋ s v ɛ j ð ɪ v ɔː n
silúngsveiðivon	s ɪː l u ŋ s v ɛ j ð ɪ v ɔː n
sjaldgæfur	s j a l t c a j v ʏ r
sjampó	s j a m̥ p ɔ u
sjálfgæfa	s j au l v c a j v a
sjálfprótein	s j au l pʰ r ɔ u tʰ ɛ j n
sjálfprótein	s j au l pʰ r ɔ u tʰ ɛ j n
sjálfsafgreiðslustöðvum	s j au l s a v k r ɛ j ð s t l ʏ s t œ ð v ʏ m
sjálfsbjargarviðleitnin	s j au l s p j a r k a r v ɪ ð l ɛ j h t n ɪ n
sjálfsstjórnar	s j au l s t j ɔ u r t n a r
sjálfsvarnaríþróttir	s j au l s v a r t n a r iː θ r ɔ u h t ɪ r
sjávarbotninn	s j aː u v a r̥ p ɔ h t n ɪ n
sjávardýpi	s j aː u v a r̥ t iː p ɪ
sjávarfalla	s j aː u v a r̥ f a t l a
sjávarfiskum	s j aː u v a r̥ f ɪ s k ʏ m
sjávarkambur	s j aː u v a r̥ k a m p ʏ r
sjávarleður	s j aː u v a r l ɛː ð ʏ r
sjávarrétta	s j aː u v a r j ɛ h t a
sjóbirtingum	s j ɔː u p ɪ r t i ŋ k ʏ m
sjóbirtingurinn	s j ɔː u p ɪ r t i ŋ k ʏ r ɪ n
sjókajak	s j ɔː u k a j a k
sjómannaafslátt	s j ɔː u m a n a a f s t l au h t
sjómannaafsláttar	s j ɔː u m a n a a f s t l au h t a r
sjómannadag	s j ɔː u m a n a t aː ɣ
sjómannadeginum	s j ɔː u m a n a t ɛ j ɪ n ʏ m
sjónarspili	s j ɔː u n a r s p ɪː l ɪ
sjónaukar	s j ɔː u n œ j k a r
sjónaukar	s j ɔː u n œ j k a r
sjónhverfingaleikinn	s j ɔ u ŋ kʰ v ɛ r v i ŋ k a l ɛː j c ɪ n
sjónhverfingaleikinn	s j ɔ u ŋ kʰ v ɛ r v i ŋ k a l ɛː j c ɪ n
sjónhæðarlínu	s j ɔː u n h a j ð a r l iː n ʏ
sjónhæðarlínu	s j ɔː u n h a j ð a r l iː n ʏ
sjónlagi	s j ɔ u n l a j ɪ
sjónlagi	s j ɔ u n l a j ɪ
sjónlista	s j ɔ u n l ɪ s t a
sjónlistum	s j ɔ u n l ɪ s t ʏ m
sjónlýti	s j ɔ u n l iː t ɪ
sjónskerta	s j ɔ u n s c ɛ r̥ t a
sjónubólgan	s j ɔː u n ʏ p ɔ u l k a n
sjónvarpsauglýsinga	s j ɔ u n v a r̥ s œ j ɣ l i s i ŋ k a
sjónvarpsauglýsinga	s j ɔ u n v a r̥ s œ j ɣ l i s i ŋ k a
sjónvarpsauglýsingar	s j ɔ u n v a r̥ s œ j ɣ l i s i ŋ k a r
sjónvarpsauglýsingar	s j ɔ u n v a r̥ s œ j ɣ l i s i ŋ k a r
sjónvarpskokkurinn	s j ɔ u n v a r̥ s kʰ ɔ h k ʏ r ɪ n
sjónvarpskort	s j ɔ u n v a r̥ s kʰ ɔ r̥ t
sjónvarpskvöld	s j ɔ u n v a r̥ s kʰ v œ l t
sjónvarpsmiðin	s j ɔ u n v a r̥ s m ɪː ð ɪ n
sjónvarpsrýni	s j ɔ u n v a r̥ s r iː n ɪ
sjónvarpssendingar	s j ɔ u n v a r̥ s ɛ n t i ŋ k a r
sjónvarpssjúklingur	s j ɔ u n v a r̥ s j u h k l i ŋ k ʏ r
sjónvarpsskjánum	s j ɔ u n v a r̥ s c aː u n ʏ m
sjónvarpsskjánum	s j ɔ u n v a r̥ s c aː u n ʏ m
sjónvarpsstjarnan	s j ɔ u n v a r̥ s t j a r t n a n
sjónvarpstengi	s j ɔ u n v a r̥ s tʰ ɛ j ɲ c ɪ
sjónvarpstengi	s j ɔ u n v a r̥ s tʰ ɛ j ɲ c ɪ
sjónvarpstímaritsins	s j ɔ u n v a r̥ s tʰ iː m a r ɪ t s ɪ n s
sjónvarpstöðina	s j ɔ u n v a r̥ p s t œː ð ɪ n a
sjónvörp	s j ɔ u n v œ r̥ p
sjónvörpum	s j ɔ u n v œ r̥ p ʏ m
sjóstangaveiðimenn	s j ɔː u s t au ŋ k a v ɛː j ð ɪ m ɛ n
sjóstangaveiðimenn	s j ɔː u s t au ŋ k a v ɛː j ð ɪ m ɛ n
sjúkdómaflokka	s j u k t ɔ u m a f l ɔ h k a
sjúkdómatryggingu	s j u k t ɔ u m a tʰ r ɪ c i ŋ k ʏ
sjúkdómsfelli	s j u k t ɔ u m s f ɛ t l ɪ
sjúkdómsvaldandi	s j u k t ɔ u m s v a l t a n t ɪ
sjúklingahópi	s j u h k l i ŋ k a h ɔː u p ɪ
skaðabótalaga	s k aː ð a p ɔ u t a l aː ɣ a
skaðabótareglur	s k aː ð a p ɔ u t a r ɛ k l ʏ r
skaðræðisdóna	s k a ð r a j ð ɪ s t ɔː u n a
skaðræðisdóna	s k a ð r a j ð ɪ s t ɔː u n a
skaftárveitu	s k a f t au r v ɛː j t ʏ
skagafjarðardeild	s k aː ɣ a f j a r ð a r t ɛ j l t
skaginn	s k a j ɪ n
skammtaskráa	s k a m̥ t a s k r aː u a
skapgóð	s k aː p k ɔ u ð
skarfaætt	s k a r v a a j h t
skarphéðinsdóttur	s k a r̥ p ç ɛ ð ɪ n s t ɔ u h t ʏ r
skattasérfræðingar	s k a h t a s j ɛ r̥ f r a j ð i ŋ k a r
skattgreiðslur	s k a h t k r ɛ j ð s t l ʏ r
skaupið	s k œː j p ɪ ð
skaust	s k au s ð
skautahlauparinn	s k œː j t a l̥ œː j p a r ɪ n
skákborð	s k aː u k p ɔ r ð
skákmannanna	s k aː u k m a n a n a
skákmanninum	s k aː u k m a n ɪ n ʏ m
skákmaraþon	s k aː u k m a r a θ ɔ n
skálarnar	s k aː u l a t n a r
skálasvæða	s k aː u l a s v a j ð a
skálasvæða	s k aː u l a s v a j ð a
skálavörður	s k aː u l a v œ r ð ʏ r
skáldaleyfi	s k au l t a l ɛː j v ɪ
skáldmælt	s k au l t m a j l̥ t
skárust	s k aː u r ʏ s t
skátaflokkurinn	s k aː u t a f l ɔ h k ʏ r ɪ n
skátanámskeið	s k aː u t a n au m s c ɛ j ð
skátastarfsins	s k aː u t a s t a r s ɪ n s
skeiða	s c ɛː j ð a
skeiðahreppi	s c ɛː j ð a r̥ ɛ h p ɪ
skeiðahrepps	s c ɛː j ð a r̥ ɛ h p s
Skeiðarvogi	s c eiː ð a r v ɔː j ɪ
skeifueyja	s c ɛː j v ʏ ɛː j a
skeifuna	s c ɛː j v ʏ n a
skeikar	s c ɛː j k a r
skelfiskeitrun	s c ɛ l f ɪ s k ɛː j t r ʏ n
skellihlógum	s c ɛ t l ɪ l̥ ɔː u ʏ m
skemmtibáta	s c ɛ m̥ t ɪ p aː u t a
skemmtibátur	s c ɛ m̥ t ɪ p aː u t ʏ r
skemmtigönguleið	s c ɛ m̥ t ɪ k œ j ŋ k ʏ l ɛː j ð
skemmtigönguleið	s c ɛ m̥ t ɪ k œ j ŋ k ʏ l ɛː j ð
skermleiðirinn	s c ɛ r m l ɛ j ð ɪ r ɪ n
skilgreinið	s c ɪ l k r ɛ j n ɪ ð
skimprófi	s c ɪː m̥ p r ɔ u ɪ
skipakaup	s c ɪː p a kʰ œː j p
skipaskrá	s c ɪː p a s k r aː u
skipstjóraklefanum	s c ɪ f s t j ɔ u r a kʰ l ɛː v a n ʏ m
skipstjórnarsvið	s c ɪ f s t j ɔ u r t n a r̥ s v ɪ ð
skiptiheimsóknir	s c ɪ f t ɪ h ɛ j m s ɔ u h k n ɪ r
skiptiheimsóknir	s c ɪ f t ɪ h ɛ j m s ɔ u h k n ɪ r
skipulagi	s c ɪː p ʏ l aː j ɪ
skipulagið	s c ɪː p ʏ l aː j ɪ ð
skipulaginu	s c ɪː p ʏ l aː j ɪ n ʏ
skipulagsfræðingur	s c ɪː p ʏ l a k s f r aː j ð i ŋ k ʏ r
skíðabátar	s c iː ð a p aː u t a r
skíðabogi	s c iː ð a p ɔː j ɪ
skíðasvæðinu	s c iː ð a s v aː j ð ɪ n ʏ
skírdaginn	s c i r t a j ɪ n
skírnarveislu	s c i r t n a r v ɛ j s t l ʏ
skíthrædd	s c iː t r̥ a j t
skítsæmilegt	s c iː t s a j m ɪ l ɛ x t
skjálfandafljóti	s c au l v a n t a f l j ɔː u t ɪ
skjólbelta	s c ɔ u l p ɛ l̥ t a
skjólbeltarækt	s c ɔ u l p ɛ l̥ t a r a j x t
skjólbeltarækt	s c ɔ u l p ɛ l̥ t a r a j x t
skjótbúnir	s c ɔː u t p u n ɪ r
skjótlega	s c ɔː u t l ɛ ɣ a
skokkskór	s k ɔ h k s k ɔ u r
skolhærð	s k ɔː l h a j r ð
skollaurðina	s k ɔ t l a ʏ r ð ɪ n a
skotstjórar	s k ɔː t s t j ɔ u r a r
skottulæknisins	s k ɔ h t ʏ l a j h k n ɪ s ɪ n s
skotveiðimanna	s k ɔː t v ɛ j ð ɪ m a n a
skotveiðimönnum	s k ɔː t v ɛ j ð ɪ m œ n ʏ m
skógarbæjar	s k ɔː u a r p a j a r
skógarbæjar	s k ɔː u a r p a j a r
skógarbænda	s k ɔː u a r p a j n t a
skógarbænda	s k ɔː u a r p a j n t a
skógarhlaupi	s k ɔː u a r l̥ œː j p ɪ
skógarhlaupi	s k ɔː u a r l̥ œː j p ɪ
skógarplantna	s k ɔː u a r p l a n̥ t n a
skógarsvæðinu	s k ɔː u a r s v aː j ð ɪ n ʏ
skógarsvæðinu	s k ɔː u a r s v aː j ð ɪ n ʏ
skógarvatn	s k ɔː u a r v a h t n̥
skógnytjanefndarinnar	s k ɔː u n ɪ t j a n ɛ m t a r ɪ n a r
skógræktarmanna	s k ɔː u r a j x t a r m a n a
skógræktarmanna	s k ɔː u r a j x t a r m a n a
skógræktarstofnanir	s k ɔː u r a j x t a r s t ɔ p n a n ɪ r
skógræktarstofnanir	s k ɔː u r a j x t a r s t ɔ p n a n ɪ r
skólaaldri	s k ɔː u l a a l t r ɪ
skólablaðsvef	s k ɔː u l a p l a ð s v ɛː v
skólabyggingar	s k ɔː u l a p ɪ c i ŋ k a r
skóladagatal	s k ɔː u l a t a ɣ a tʰ aː l
skóladagatali	s k ɔː u l a t a ɣ a tʰ aː l ɪ
skóladagurinn	s k ɔː u l a t aː ɣ ʏ r ɪ n
skólaheimsókn	s k ɔː u l a h ɛ j m s ɔ u h k n̥
skólaheimsókn	s k ɔː u l a h ɛ j m s ɔ u h k n̥
skólahlaup	s k ɔː u l a l̥ œː j p
skólahlaup	s k ɔː u l a l̥ œː j p
skólakynningum	s k ɔː u l a cʰ ɪ n i ŋ k ʏ m
skólalok	s k ɔː u l a l ɔː k
skólamanna	s k ɔː u l a m a n a
skólamálastefna	s k ɔː u l a m au l a s t ɛ p n a
skólanámi	s k ɔː u l a n aː u m ɪ
skólanámi	s k ɔː u l a n aː u m ɪ
skólanefndina	s k ɔː u l a n ɛ m t ɪ n a
skólanetsins	s k ɔː u l a n ɛː t s ɪ n s
skólasetur	s k ɔː u l a s ɛː t ʏ r
skólastelpa	s k ɔː u l a s t ɛ l̥ p a
skólatorg	s k ɔː u l a tʰ ɔ r k
skólatöskuna	s k ɔː u l a tʰ œ s k ʏ n a
skólaumhverfinu	s k ɔː u l a ʏ m kʰ v ɛ r v ɪ n ʏ
skólaumhverfinu	s k ɔː u l a ʏ m kʰ v ɛ r v ɪ n ʏ
skólaveginum	s k ɔː u l a v ɛ j ɪ n ʏ m
skólpgöng	s k ɔ u l̥ p k œ j ŋ k
skólpgöng	s k ɔ u l̥ p k œ j ŋ k
skólpkerfi	s k ɔ u l̥ p cʰ ɛ r v ɪ
skólpmengun	s k ɔ u l̥ p m ɛ j ŋ k ʏ n
skólpmengun	s k ɔ u l̥ p m ɛ j ŋ k ʏ n
skólprörin	s k ɔ u l̥ p r œ r ɪ n
skólpveitu	s k ɔ u l̥ p v ɛ j t ʏ
skólpveitu	s k ɔ u l̥ p v ɛ j t ʏ
skrapatóli	s k r aː p a tʰ ɔː u l ɪ
skrauthilla	s k r œː j t h ɪ t l a
skrautlegasti	s k r œː j t l ɛ ɣ a s t ɪ
skrautleggingar	s k r œː j t l ɛ c i ŋ k a r
skrautlegur	s k r œː j t l ɛ ɣ ʏ r
skrautlýst	s k r œː j t l i s t
skrautmuni	s k r œː j t m ʏ n ɪ
skráaflutningar	s k r aː u a f l ʏ h t n i ŋ k a r
skráarsafnið	s k r aː u a r s a p n ɪ ð
skráin	s k r aː u ɪ n
skráist	s k r aː u ɪ s t
skráninga	s k r aː u n i ŋ k a
skráningarblað	s k r aː u n i ŋ k a r̥ p l a ð
skráningarfrestur	s k r aː u n i ŋ k a r̥ f r ɛ s t ʏ r
skráningargjöld	s k r aː u n i ŋ k a r̥ c œ l t
skráningargrunni	s k r aː u n i ŋ k a r̥ k r ʏ n ɪ
skráningarnúmer	s k r aː u n i ŋ k a r n uː m ɛ r
skráningarskylda	s k r aː u n i ŋ k a r̥ s c ɪ l t a
skráningarskyldir	s k r aː u n i ŋ k a r̥ s c ɪ l t ɪ r
skráningarstöfunum	s k r aː u n i ŋ k a r̥ s t œː v ɔ n ʏ m
skreiðin	s k r ɛː j ð ɪ n
skreyttan	s k r ɛ j h t a n
skreytum	s k r ɛː j t ʏ m
skriðuhætta	s k r ɪː ð ʏ h a j h t a
skrifstofufólk	s k r ɪ f s t ɔ v ʏ f ɔ u l̥ k
skrifstofutækjum	s k r ɪ f s t ɔ v ʏ tʰ aː j c ʏ m
skrípaleikurinn	s k r iː p a l ɛː j k ʏ r ɪ n
skrýtipönklaginu	s k r iː t ɪ p œ j ŋ k l a j ɪ n ʏ
skrýtipönklaginu	s k r iː t ɪ p œ j ŋ k l a j ɪ n ʏ
skrælingjar	s k r a j l i ɲ c a r
skuggabræðurnir	s k ʏ k a p r a j ð ʏ t n ɪ r
skuggadóttur	s k ʏ k a t ɔ u h t ʏ r
skuldaaukninguna	s k ʏ l t a œ j h k n i ŋ k ʏ n a
skuldbreytingarbréfi	s k ʏ l t p r ɛ j t i ŋ k a r p r j ɛː v ɪ
skuldfærslu	s k ʏ l t f a j r̥ s t l ʏ
skuldunautar	s k ʏ l t ʏ n œː j t a r
Skútuvogi	s k uː t ʏ v ɔː j ɪ
skyldleikatengsl	s c ɪ l t l ɛ j k a tʰ ɛ j ŋ s t l̥
skylmingamótið	s c ɪ l m i ŋ k a m ɔː u t ɪ ð
skyndihjálparbækurnar	s c ɪ n t ɪ ç au l̥ p a r̥ p a j k ʏ t n a r
skyndiprófum	s c ɪ n t ɪ p r ɔː u ʏ m
skyndisókn	s c ɪ n t ɪ s ɔ u h k n̥
skýjabólstri	s c iː j a p ɔ u l s t r ɪ
skærgrænt	s c a j r k r a j n̥ t
skæringsdóttir	s c aː j r i ŋ s t ɔ u h t ɪ r
skæringsdóttir	s c aː j r i ŋ s t ɔ u h t ɪ r
skæruliðasamtökin	s c aː j r ʏ l ɪ ð a s a m t œ c ɪ n
skærur	s c aː j r ʏ r
skæting	s c aː j t i ŋ k
sköllótti	s k œ t l ɔ u h t ɪ
sköllóttum	s k œ t l ɔ u h t ʏ m
skömmtunartækjum	s k œ m̥ t ʏ n a r tʰ aː j c ʏ m
sköpulagi	s k œː p ʏ l aː j ɪ
Skörðugili	s k œ r ð ʏ c ɪː l ɪ
slanga	s t l a ŋ k a
slangur	s t l a ŋ k ʏ r
sláturfénu	s t l aː u t ʏ r f j ɛː n ʏ
sláturfolöldunum	s t l aː u t ʏ r f ɔː l œ l t ɔ n ʏ m
sláturhússins	s t l aː u t ʏ r h u s ɪ n s
sleikjó	s t l ɛː j c ɔ u
sleikjó	s t l ɛː j c ɔ u
sleikjóar	s t l ɛː j c ɔ u a r
sleikjóar	s t l ɛː j c ɔ u a r
slitbreytingar	s t l ɪː t p r ɛ j t i ŋ k a r
sljó	s t l j ɔː u
slysavarnadeild	s t l ɪː s a v a r t n a t ɛ j l t
slysavarnaskólanum	s t l ɪː s a v a r t n a s k ɔː u l a n ʏ m
slæðingur	s t l aː j ð i ŋ k ʏ r
slægju	s t l a j ʏ
slættir	s t l a j h t ɪ r
slökkvibifreiðar	s t l œ h k v ɪ p ɪ v r ɛ j ð a r
smáatriðunum	s m aː u a t r ɪ ð ɔ n ʏ m
smábarnaröddu	s m aː u p a r t n a r œ t ʏ
smábeinunum	s m aː u p ɛ j n ɔ n ʏ m
smábeinunum	s m aː u p ɛ j n ɔ n ʏ m
smáglæpamanninn	s m aː u k l a j p a m a n ɪ n
smáglæpamanninn	s m aː u k l a j p a m a n ɪ n
smáhnatta	s m aː u n̥ a h t a
smárahverfinu	s m aː u r a kʰ v ɛ r v ɪ n ʏ
smáralindina	s m aː u r a l ɪ n t ɪ n a
smásagnasafn	s m aː u s a k n a s a p n̥
smásjárfrjóvgun	s m aː u s j au r̥ f r j ɔ u v ɣ ʏ n
smásmuguleg	s m aː u s m ʏ ɣ ʏ l ɛ ɣ
smeyk	s m ɛː j k
smiðjusteini	s m ɪ ð j ʏ s t ɛː j n ɪ
smiðjuteig	s m ɪ ð j ʏ tʰ ɛː j ɣ
smitdreifing	s m ɪː t r ɛ j v i ŋ k
smjörbaunum	s m j œ r p œ j n ʏ m
smjörhræruna	s m j œ r̥ a j r ʏ n a
smjörsteiktar	s m j œ r̥ s t ɛ j x t a r
smjörsteiktu	s m j œ r̥ s t ɛ j x t ʏ
smokkfisklengjum	s m ɔ h k f ɪ s k l ɛ j ɲ c ʏ m
snarvitlausu	s t n a r v ɪ h t l œː j s ʏ
sneiðir	s t n ɛː j ð ɪ r
sneiðskratti	s t n ɛ j ð s k r a h t ɪ
snertiofnæmi	s t n ɛ r̥ t ɪ ɔ v n a j m ɪ
snertiskjá	s t n ɛ r̥ t ɪ s c aː u
sneyptur	s t n ɛ j f t ʏ r
sniðmengi	s t n ɪ ð m ɛ j ɲ c ɪ
snilldarleikur	s t n ɪ l t a r l ɛː j k ʏ r
snilligáfan	s t n ɪ t l ɪ k aː u v a n
snjóleysis	s t n j ɔː u l ɛ j s ɪ s
snjóleysis	s t n j ɔː u l ɛ j s ɪ s
snjótittlingur	s t n j ɔː u t ɪ h t l i ŋ k ʏ r
snúningsfæti	s t n uː n i ŋ s f a j t ɪ
snúningshraðamæli	s t n uː n i ŋ s r̥ a ð a m aː j l ɪ
snyrtidótinu	s t n ɪ r̥ t ɪ t ɔː u t ɪ n ʏ
snædd	s t n a j t
snæfellsjökli	s t n aː j f ɛ l s j œ h k l ɪ
snæfellsjökull	s t n aː j f ɛ l s j œː k ʏ t l̥
snæfellsport	s t n aː j f ɛ l s p ɔ r̥ t
snæfjallahreppur	s t n aː j f j a t l a r̥ ɛ h p ʏ r
snældubandið	s t n a j l t ʏ p a n t ɪ ð
snældur	s t n a j l t ʏ r
snældusnúðar	s t n a j l t ʏ s t n u ð a r
snögghærður	s t n œ k h a j r ð ʏ r
soggrein	s ɔ ɣ k r ɛ j n
sorpgeymslu	s ɔ r̥ p c ɛ j m s t l ʏ
sorphaugum	s ɔ r̥ p h œ j ɣ ʏ m
spangólaði	s p a ŋ k ou l a ð ɪ
sparibaukur	s p aː r ɪ p œː j k ʏ r
sparisjóð	s p aː r ɪ s j ɔː u ð
spariskírteini	s p aː r ɪ s c i r̥ t ɛ j n ɪ
sparneytni	s p a r n ɛ j h t n ɪ
spaugstofuna	s p œ j x s t ɔ v ʏ n a
spánarkappakstrinum	s p aː u n a r̥ kʰ a h p a k s t r ɪ n ʏ m
spennujöfnunartenginga	s p ɛ n ʏ j œ p n ʏ n a r̥ tʰ ɛ j ɲ c i ŋ k a
spítalahjólum	s p iː t a l a ç ɔː u l ʏ m
splæstum	s p l a j s t ʏ m
sporbaug	s p ɔ r p œ j ɣ
spónlagðir	s p ɔ u n l a ɣ ð ɪ r
sprautar	s p r œː j t a r
sprautunina	s p r œː j t ʏ n ɪ n a
sprautunni	s p r œː j t ʏ n ɪ
sprautur	s p r œː j t ʏ r
sprengdar	s p r ɛ j ŋ t a r
sprenghlægileg	s p r ɛ j ŋ k l̥ a j ɪ l ɛː ɣ
sprenghlægileg	s p r ɛ j ŋ k l̥ a j ɪ l ɛː ɣ
sprengisandsleið	s p r ɛ j ɲ c ɪ s a n t s l ɛː j ð
sprengjuflugvélin	s p r ɛ j ɲ c ʏ f l ʏ ɣ v j ɛ l ɪ n
sprengjugígar	s p r ɛ j ɲ c ʏ k iː ɣ a r
sprengjuhótun	s p r ɛ j ɲ c ʏ h ɔː u t ʏ n
sprengjuhótun	s p r ɛ j ɲ c ʏ h ɔː u t ʏ n
sprengjulátunum	s p r ɛ j ɲ c ʏ l aː u t ɔ n ʏ m
sprengjulátunum	s p r ɛ j ɲ c ʏ l aː u t ɔ n ʏ m
sprengt	s p r ɛ ŋ̊ t
sprengt	s p r ɛ ŋ t
sprotakáli	s p r ɔː t a kʰ aː u l ɪ
spunafólk	s p ʏː n a f ɔ u l̥ k
spæjarakrakkar	s p a j a r a kʰ r a h k a r
spænskar	s p a j n s k a r
spöng	s p œ j ŋ k
spöngina	s p œ j ɲ c ɪ n a
staðarsveit	s t aː ð a r̥ s v ɛː j t
staðarsveitar	s t aː ð a r̥ s v ɛ j t a r
stafrófsröð	s t a v r ɔ u f s r œː ð
stafræni	s t a v r a j n ɪ
stafrænna	s t a v r a j t n a
stafræns	s t a v r a j n s
stakstæð	s t aː k s t a j ð
starfsbrautar	s t a r s p r œ j t a r
starfsendurhæfingu	s t a r s ɛ n t ʏ r h aː j v i ŋ k ʏ
starfsgreinar	s t a r s k r ɛ j n a r
starfsgreinaráð	s t a r s k r ɛ j n a r aː u ð
starfsgreinaráð	s t a r s k r ɛ j n a r aː u ð
starfsheita	s t a r s h ɛ j t a
starfshópi	s t a r s h ɔ u p ɪ
starfsleyfa	s t a r s l ɛ j v a
starfsleyfisveiting	s t a r s t l ɛ j v ɪ s v ɛː j t i ŋ k
starfsmannafræðsla	s t a r s m a n a f r a j ð s t l a
starfsmenntunarsjóð	s t a r s m ɛ n̥ t ʏ n a r̥ s j ɔː u ð
starfsmenntunarsjóður	s t a r s m ɛ n̥ t ʏ n a r̥ s j ɔː u ð ʏ r
starfsmöguleikum	s t a r s m œ ɣ ʏ l ɛː j k ʏ m
starfsrækslu	s t a r s r a j k s t l ʏ
starfstengt	s t a r s t ɛ j ŋ̊ t
stauknum	s t œ j h k n ʏ m
staurblankir	s t œy r p l a ŋ̊ c ɪ r
staurblankir	s t œy r p l a ŋ̊ c ɪ r
staurblindum	s t œ j r p l ɪ n t ʏ m
stautar	s t œː j t a r
steikhúsi	s t ɛː j k h u s ɪ
steinaldarkonur	s t ɛː j n a l t a r̥ kʰ ɔː n ʏ r
steinaldarmyndum	s t ɛː j n a l t a r m ɪ n t ʏ m
steinaldarþorp	s t ɛː j n a l t a r̥ θ ɔ r̥ p
steinbítskví	s t ɛ j m p i t s k v iː
steindauðar	s t ɛ j n t œ j ð a r
steindauðar	s t ɛ j n t œ j ð a r
steindepill	s t ɛ j n t ɛ p ɪ t l̥
steindóri	s t ɛ j n t ɔ u r ɪ
steindóri	s t ɛ j n t ɔ u r ɪ
steindrapst	s t ɛ j n t r a f s t
steinefnablöndur	s t ɛ j n ɛ p n a p l œ n t ʏ r
steinefnagjafar	s t ɛ j n ɛ p n a c aː v a r
steinefni	s t ɛː j n ɛ p n ɪ
steinefnum	s t ɛː j n ɛ p n ʏ m
steingeitin	s t ɛ j ŋ c ɛ j t ɪ n
steingervinginn	s t ɛ j ɲ c ɛ r v i ɲ c ɪ n
steinglergluggum	s t ɛ j ŋ k l ɛ r k l ʏ k ʏ m
steinhnullungum	s t ɛː j n̥ ʏ t l u ŋ k ʏ m
steinhring	s t ɛː j n r̥ i ŋ k
steinhæðir	s t ɛː j n h a j ð ɪ r
steinhæðir	s t ɛː j n h a j ð ɪ r
steinmúr	s t ɛ j n m u r
steinsef	s t ɛ j n s ɛ f
steinselja	s t ɛ j n s ɛ l j a
steinselju	s t ɛ j n s ɛ l j ʏ
steinsteyptan	s t ɛ j n s t ɛ j f t a n
steinvölum	s t ɛ j n v œ l ʏ m
sterkstraumshluti	s t ɛ r̥ k s t r œ j m s l̥ ʏː t ɪ
steyping	s t ɛː j p i ŋ k
steypta	s t ɛ j f t a
steyptur	s t ɛ j f t ʏ r
steypuhrærivélarnar	s t ɛː j p ʏ r̥ a j r ɪ v j ɛː l a t n a r
steypuhrærivélarnar	s t ɛː j p ʏ r̥ a j r ɪ v j ɛː l a t n a r
steypum	s t ɛː j p ʏ m
steypustöð	s t ɛː j p ʏ s t œː ð
stélflatarsætinu	s t j ɛː l f l a t a r̥ s aː j t ɪ n ʏ
stéttarbræður	s t j ɛ h t a r̥ p r a j ð ʏ r
stéttlausir	s t j ɛ h t l œ j s ɪ r
stéttlausra	s t j ɛ h t l œ j s r a
stéttlaust	s t j ɛ h t l œ j s t
stigateikningu	s t ɪː ɣ a tʰ ɛ j h k n i ŋ k ʏ
stilklöng	s t ɪ l̥ h k l œ j ŋ k
stílfært	s t i l f a j r̥ t
stjarnfrumnaæxli	s t j a r t n f r ʏ m n a a j k s t l ɪ
stjarnfræðieininga	s t j a r t n f r a j ð ɪ ɛː j n i ŋ k a
stjarnfræðieininga	s t j a r t n f r a j ð ɪ ɛː j n i ŋ k a
stjarnfræðileg	s t j a r t n f r a j ð ɪ l ɛ ɣ
stjórnandanum	s t j ɔ u r t n a n t a n ʏ m
stjórnarandstöðuflokkarnir	s t j ɔ u r t n a r a n t s t œ ð ʏ f l ɔ h k a t n ɪ r
stjórnardeildarinnar	s t j ɔ u r t n a r̥ t ɛ j l t a r ɪ n a r
stjórnardeildarinnar	s t j ɔ u r t n a r̥ t ɛ j l t a r ɪ n a r
stjórnarfólks	s t j ɔ u r t n a r̥ f ɔ u l̥ k s
stjórnarfundinum	s t j ɔ u r t n a r̥ f ʏ n t ɪ n ʏ m
stjórnarkjörs	s t j ɔ u r t n a r̥ cʰ œ r̥ s
stjórnarliðar	s t j ɔ u r t n a r l ɪ ð a r
stjórnarmaðurinn	s t j ɔ u r t n a r m aː ð ʏ r ɪ n
stjórnarmeðlimir	s t j ɔ u r t n a r m ɛ ð l ɪ m ɪ r
stjórnarmynstur	s t j ɔ u r t n a r m ɪ n s t ʏ r
stjórnarnefnd	s t j ɔ u r t n a r n ɛ m t
stjórnarnefndir	s t j ɔ u r t n a r n ɛ m t ɪ r
stjórnarsáttmálann	s t j ɔ u r t n a r̥ s au h t m au l a n
stjórnarskráa	s t j ɔ u r t n a r̥ s k r aː u a
stjórnarskráa	s t j ɔ u r t n a r̥ s k r aː u a
stjórnarskrárnefndar	s t j ɔ u r t n a r̥ s k r au r n ɛ m t a r
stjórnartíðinda	s t j ɔ u r t n a r̥ tʰ iː ð ɪ n t a
stjórnborð	s t j ɔ u r t n p ɔ r ð
stjórnendareglur	s t j ɔ u r t n ɛ n t a r ɛ k l ʏ r
stjórnendaskóli	s t j ɔ u r t n ɛ n t a s k ɔː u l ɪ
stjórnför	s t j ɔ u r t n f œː r
stjórnherbergi	s t j ɔ u r t n̥ h ɛ r p ɛ r c ɪ
stjórnhnappinum	s t j ɔ u r t n n̥ a h p ɪ n ʏ m
stjórnkerfis	s t j ɔ u r t n̥ cʰ ɛ r v ɪ s
stjórnleysingjar	s t j ɔ u r t n̥ l ɛ j s i ɲ c a r
stjórnleysingjar	s t j ɔ u r t n̥ l ɛ j s i ɲ c a r
stjórnmálaforingjar	s t j ɔ u r t n̥ m au l a f ɔː r i ɲ c a r
stjórnmálafræðiskor	s t j ɔ u r t n̥ m au l a f r a j ð ɪ s k ɔː r
stjórnmálafræðiskor	s t j ɔ u r t n̥ m au l a f r a j ð ɪ s k ɔː r
stjórnmálahagfræðingur	s t j ɔ u r t n̥ m au l a h a x f r a j ð i ŋ k ʏ r
stjórnmálahagfræðingur	s t j ɔ u r t n̥ m au l a h a x f r a j ð i ŋ k ʏ r
stjórnmálakreppu	s t j ɔ u r t n̥ m au l a k r ɛ h p ʏ
stjórnmálasambands	s t j ɔ u r t n̥ m au l a s a m p a n t s
stjórnmálaskoðanir	s t j ɔ u r t n̥ m au l a s k ɔː ð a n ɪ r
stjórnskipulegan	s t j ɔ u r t n̥ s c ɪ p ʏ l ɛː ɣ a n
stjórnstaður	s t j ɔ u r t n̥ s t a ð ʏ r
stjórnstöngum	s t j ɔ u r t n̥ s t œ j ŋ k ʏ m
stjórnstöngum	s t j ɔ u r t n̥ s t œ j ŋ k ʏ m
stjórnsýslan	s t j ɔ u r t n̥ s i s t l a n
stjórnsýsluleg	s t j ɔ u r t n̥ s i s t l ʏ l ɛ ɣ
stjórnunarlegri	s t j ɔ u r t n ʏ n a r l ɛ ɣ r ɪ
stjórnvalds	s t j ɔ u r t n v a l t s
stjúpdóttur	s t j uː p t ɔ u h t ʏ r
stjörnubækur	s t j œ r t n ʏ p aː j k ʏ r
stjörnufræðingar	s t j œ r t n ʏ f r aː j ð i ŋ k a r
stjörnufræðistöðin	s t j œ r t n ʏ f r a j ð ɪ s t œː ð ɪ n
stjörnunótt	s t j œ r t n ʏ n ɔ u h t
stjörnutengdir	s t j œ r t n ʏ tʰ ɛ j ŋ t ɪ r
stoðgreinanna	s t ɔ ð k r ɛ j n a n a
stofnefnahagsreikning	s t ɔ p n ɛ p n a h a x s r ɛ j h k n i ŋ k
stofnstærðarmat	s t ɔ p n̥ s t a j r ð a r m aː t
stofnvistfræðingur	s t ɔ p n̥ v ɪ s t f r a j ð i ŋ k ʏ r
stólpi	s t ɔ u l̥ p ɪ
stórahjalla	s t ɔː u r a ç a t l a
stórbókin	s t ɔ u r p ɔ u c ɪ n
stórbú	s t ɔ u r p u
stórbæja	s t ɔ u r p a j a
stórbæja	s t ɔ u r p a j a
stórbættar	s t ɔ u r p a j h t a r
stórbættar	s t ɔ u r p a j h t a r
stórbætti	s t ɔ u r p a j h t ɪ
stórbætti	s t ɔ u r p a j h t ɪ
stóreflst	s t ɔː u r ɛ v l̥ s t
stórefnilegir	s t ɔː u r ɛ p n ɪ l ɛː j ɪ r
stórfengleika	s t ɔ u r̥ f ɛ j ŋ k l ɛː j k a
stórfengleika	s t ɔ u r̥ f ɛ j ŋ k l ɛː j k a
stórgerður	s t ɔ u r c ɛ r ð ʏ r
stórgóðir	s t ɔ u r k ɔ u ð ɪ r
stórgóður	s t ɔ u r k ɔ u ð ʏ r
stórhlaupari	s t ɔː u r̥ l̥ œ j p a r ɪ
stórhlaupari	s t ɔː u r̥ l̥ œ j p a r ɪ
stórhljómsveitinni	s t ɔː u r̥ l̥ j ɔ u m s v ɛ j t ɪ n ɪ
stórhljómsveitinni	s t ɔː u r̥ l̥ j ɔ u m s v ɛ j t ɪ n ɪ
stórhneyksluð	s t ɔː u r̥ n̥ ɛ j k s t l ʏ ð
stórhneyksluð	s t ɔː u r̥ n̥ ɛ j k s t l ʏ ð
stórhveli	s t ɔ u r̥ kʰ v ɛ l ɪ
stórhýsinu	s t ɔː u r h i s ɪ n ʏ
stórhættur	s t ɔː u r h a j h t ʏ r
stórhættur	s t ɔː u r h a j h t ʏ r
stórkostlegustu	s t ɔ u r̥ kʰ ɔ s t l ɛː ɣ ʏ s t ʏ
stórleika	s t ɔ u r l ɛ j k a
stórleika	s t ɔ u r l ɛ j k a
stórleikinn	s t ɔ u r l ɛ j c ɪ n
stórleikinn	s t ɔ u r l ɛ j c ɪ n
stórleikur	s t ɔ u r l ɛ j k ʏ r
stórleikur	s t ɔ u r l ɛ j k ʏ r
stórliðsins	s t ɔ u r l ɪ ð s ɪ n s
stórlækka	s t ɔ u r l a j h k a
stórlækka	s t ɔ u r l a j h k a
stórmeistarann	s t ɔ u r m ɛ j s t a r a n
stórmeistarann	s t ɔ u r m ɛ j s t a r a n
stórmeistarans	s t ɔ u r m ɛ j s t a r a n s
stórmeistarans	s t ɔ u r m ɛ j s t a r a n s
stórmyndum	s t ɔ u r m ʏ n t ʏ m
stórmörkuðunum	s t ɔ u r m œ r̥ k ʏ ð ɔ n ʏ m
stórsekk	s t ɔ u r̥ s ɛ h k
stórsniðuga	s t ɔ u r̥ s t n ɪ ð ʏ ɣ a
stórsnillingar	s t ɔ u r̥ s t n ɪ t l i ŋ k a r
stórstjarna	s t ɔ u r̥ s t j a r t n a
stórstjörnum	s t ɔ u r̥ s t j œ r t n ʏ m
stóruurð	s t ɔː u r ʏ ʏ r ð
stóruvelli	s t ɔː u r ʏ v ɛ t l ɪ
stóruvellir	s t ɔː u r ʏ v ɛ t l ɪ r
stórverk	s t ɔ u r v ɛ r̥ k
stórverkum	s t ɔ u r v ɛ r̥ k ʏ m
strandbærinn	s t r a n t p a j r ɪ n
strandlengju	s t r a n t l ɛ j ɲ c ʏ
strandsvæðinu	s t r a n t s v a j ð ɪ n ʏ
strandveiðiskip	s t r a n t v ɛ j ð ɪ s c ɪː p
stranga	s t r a ŋ k a
strangan	s t r a ŋ k a n
strangar	s t r a ŋ k a r
strangari	s t r a ŋ k a r ɪ
stranglega	s t r a ŋ k l ɛ ɣ a
strangri	s t r a ŋ k r ɪ
strangt	s t r a ŋ̊ t
strangur	s t r a ŋ k ʏ r
straujar	s t r œː j a r
straumdal	s t r œ j m t a l
straumfjarðarsvæðinu	s t r œ j m f j a r ð a s v aː j ð ɪ n ʏ
straumfjarðarsvæðinu	s t r œ j m f j a r ð a s v aː j ð ɪ n ʏ
straumflugur	s t r œ j m f l ʏ ɣ ʏ r
straumhnoð	s t r œ j m n̥ ɔ ð
straumpúlsa	s t r œ j ʏ m̥ pʰ u l s a
straumurinn	s t r œː j m ʏ r ɪ n
straumvötnum	s t r œ j m v œ h t n ʏ m
strákaferð	s t r aː u k a f ɛ r ð
streitist	s t r ɛː j t ɪ s t
streittust	s t r ɛ j h t ʏ s t
strengd	s t r ɛ j ŋ t
strenginn	s t r ɛ j ɲ c ɪ n
strengjabaunir	s t r ɛ j ɲ c a p œː j n ɪ r
strengjabaunir	s t r ɛ j ɲ c a p œː j n ɪ r
strengjakvartettinn	s t r ɛ j ɲ c a kʰ v a r̥ t ɛ h t ɪ n
strengjaoktett	s t r ɛ j ɲ c a ɔ x t ɛ h t
strengjasmiðjuna	s t r ɛ j ɲ c a s m ɪ ð j ʏ n a
strengnum	s t r ɛ j ŋ n ʏ m
stríðshrjáða	s t r i ð s r̥ j aː u ð a
strætisvagnastöðvum	s t r aː j t ɪ s v a k n a s t œ ð v ʏ m
stuðlaheiðardal	s t ʏ ð l a h ɛ j ð a r t aː l
stuðningsfólks	s t ʏ ð n i ŋ s f ɔ u l̥ k s
stuðningteymis	s t ʏ ð n i ŋ s tʰ ɛː j m ɪ s
sturludóttur	s t ʏ r t l ʏ t ɔ u h t ʏ r
stuttkjóll	s t ʏ h t cʰ ɔ u t l̥
stúdentaleiðtoginn	s t uː t ɛ n̥ t a l ɛ j ð tʰ ɔ j ɪ n
stúdentaleiðtoginn	s t uː t ɛ n̥ t a l ɛ j ð tʰ ɔ j ɪ n
stúdentsafmæli	s t uː t ɛ n̥ t s a v m a j l ɪ
stúdentsveisla	s t uː t ɛ n̥ t s v ɛ j s t l a
styrkjaumhverfi	s t ɪ r̥ c a ʏ m k v ɛ r v ɪ
styrkleikaflokka	s t ɪ r̥ k l ɛ j k a f l ɔ h k a
styrkleikanum	s t ɪ r̥ k l ɛ j k a n ʏ m
styrkleikar	s t ɪ r̥ k l ɛ j k a r
styrkveitingar	s t ɪ r̥ kʰ v ɛ j t i ŋ k a r
stýrihópur	s t iː r ɪ h ɔː u p ʏ r
stýrishjóls	s t iː r ɪ s ç ɔ u l s
stæðilega	s t aː j ð ɪ l ɛ ɣ a
stæðin	s t aː j ð ɪ n
stækan	s t aː j k a n
stærðardreifingu	s t a j r ð a r t r ɛː j v i ŋ k ʏ
stærðardreifingu	s t a j r ð a r t r ɛː j v i ŋ k ʏ
stærðirnar	s t a j r ð ɪ t n a r
stöðuleiki	s t œː ð ʏ l ɛː j c ɪ
stöðuleyfi	s t œː ð ʏ l ɛː j v ɪ
stökkbreytingin	s t œ h k p r ɛ j t i ɲ c ɪ n
stökkbreytingum	s t œ h k p r ɛ j t i ŋ k ʏ m
stökkhópa	s t œ h k h ɔ u p a
suðausturendann	s ʏː ð œ j s t ʏ r ɛ n t a n
suðrænir	s ʏ ð r a j n ɪ r
suðrænn	s ʏ ð r a j t n̥
suðurhafseyjuna	s ʏː ð ʏ r h a f s ɛː j ʏ n a
suðurkjördæmi	s ʏː ð ʏ r̥ cʰ œ r t a j m ɪ
suðurlandsskóga	s ʏː ð ʏ r l a n t s k ɔː u a
suðurnesjadeildar	s ʏː ð ʏ r n ɛ s j a t ɛ j l t a r
suðurpóllinn	s ʏː ð ʏ r pʰ ɔ u t l ɪ n
suðursjó	s ʏː ð ʏ r s j ɔː u
suðursjór	s ʏː ð ʏ r s j ɔː u r
suðurskautslandinu	s ʏː ð ʏ r s k œ j t s t l a n t ɪ n ʏ
sumardagsnóttina	s ʏː m a r t a k s t n ɔ u h t ɪ n a
sumarhópanna	s ʏː m a r h ɔː u p a n a
sumarnámskeið	s ʏː m a r n au m s c ɛ j ð
sumarratleik	s ʏː m a r aː t l ɛ j k
sundabraut	s ʏ n t a p r œː j t
sunddeild	s ʏ n t ɛ j l t
sunddeildar	s ʏ n t ɛ j l t a r
sundgleraugu	s ʏ n t k l ɛ r œː j ɣ ʏ
sundlaugarbakkann	s ʏ n t l œ j ɣ a r p a h k a n
sundlaugarpartí	s ʏ n t l œ j ɣ a r pʰ a r̥ tʰ i
sundlaugarvarsla	s ʏ n t l œ j ɣ a v a r̥ s t l a
sundlaugunum	s ʏ n t l œ j ɣ ɔ n ʏ m
sundurgreiningin	s ʏ n t ʏ r̥ k r ɛː j n i ɲ c ɪ n
sundurlaust	s ʏ n t ʏ r l œ j s t
sundurtættir	s ʏ n t ʏ r̥ tʰ a j h t ɪ r
sunnudagaskólanum	s ʏ n ʏ t aː ɣ a s k ɔː u l a n ʏ m
sunnukórsins	s ʏ n ʏ kʰ ɔ u r̥ s ɪ n s
sussumsvei	s ʏ s ʏ m s v ɛː j
Súðarvogi	s uː ð a r v ɔː j ɪ
svargrár	s v a r k r aː u r
sveifar	s v ɛː j v a r
sveiflukennd	s v ɛ j p l ʏ cʰ ɛ n t
sveigjanlegu	s v ɛː j a n l ɛː ɣ ʏ
sveigmyndaðir	s v ɛ j ɣ m ɪ n t a ð ɪ r
sveinagjár	s v ɛː j n a c aː u r
sveinagjár	s v ɛː j n a c aː u r
sveinaleikurinn	s v ɛː j n a l ɛː j k ʏ r ɪ n
sveinbjörgu	s v ɛ j m p j œ r k ʏ
sveinsprófs	s v ɛ j n s pʰ r ɔ u f s
sveinsprófs	s v ɛ j n s pʰ r ɔ u f s
sveinsstykki	s v ɛ j n s t ɪ h c ɪ
sveipuðust	s v ɛː j p ʏ ð ʏ s t
sveitaballs	s v ɛː j t a p a l s
sveitabærinn	s v ɛː j t a p aː j r ɪ n
sveitabærinn	s v ɛː j t a p aː j r ɪ n
sveitafólk	s v ɛː j t a f ɔ u l̥ k
sveitafólk	s v ɛː j t a f ɔ u l̥ k
sveitahjartað	s v ɛː j t a ç a r̥ t a ð
sveitarstjórnakosninga	s v ɛː j t a r̥ s t j ɔ u r t n a kʰ ɔ s t n i ŋ k a
sveitarstjórnakosninga	s v ɛː j t a r̥ s t j ɔ u r t n a kʰ ɔ s t n i ŋ k a
sveitarstjórnarkosninga	s v ɛː j t a r̥ s t j ɔ u r t n a r̥ kʰ ɔ s t n i ŋ k a
sveitarstjórnarkosninga	s v ɛː j t a r̥ s t j ɔ u r t n a r̥ kʰ ɔ s t n i ŋ k a
sveitarstjórnarmaður	s v ɛː j t a r̥ s t j ɔ u r t n a r m aː ð ʏ r
sveitarstjórnarmaður	s v ɛː j t a r̥ s t j ɔ u r t n a r m aː ð ʏ r
sveitasímana	s v ɛː j t a s iː m a n a
sveitastjórnir	s v ɛː j t a s t j ɔ u r t n ɪ r
sveitastjórnir	s v ɛː j t a s t j ɔ u r t n ɪ r
sveitasöngva	s v ɛː j t a s œ j ŋ k v a
sveitasöngva	s v ɛː j t a s œ j ŋ k v a
sveppaeitri	s v ɛ h p a ɛː j t r ɪ
sveppaeiturs	s v ɛ h p a ɛː j t ʏ r̥ s
sveppagróður	s v ɛ h p a k r ɔː u ð ʏ r
svepparannsókn	s v ɛ h p a r a n s ɔ u h k n̥
sveskjugrautur	s v ɛ s c ʏ k r œː j t ʏ r
sveskjumauk	s v ɛ s c ʏ m œː j k
svigmóti	s v ɪ k m ɔ u t ɪ
svindlheimur	s v ɪ n t l̥ h ɛ j m ʏ r
svipgóð	s v ɪː p k ɔ u ð
svitaeyðir	s v ɪː t a ɛː j ð ɪ r
svíney	s v iː n ɛ j
svæðalokana	s v aː j ð a l ɔː k a n a
svæðislýsingunni	s v aː j ð ɪ s l iː s i ŋ k ʏ n ɪ
svæðisnúmer	s v aː j ð ɪ s n uː m ɛ r
svæðisvinnumiðlun	s v aː j ð ɪ s v ɪ n ʏ m ɪ ð l ʏ n
svæðisvinnumiðlunar	s v aː j ð ɪ s v ɪ n ʏ m ɪ ð l ʏ n a r
svæfinga	s v aː j v i ŋ k a
svæfingadeild	s v aː j v i ŋ k a t ɛ j l t
svæfingadeild	s v aː j v i ŋ k a t ɛ j l t
sykurflotvoginni	s ɪː k ʏ r̥ f l ɔ t v ɔ j ɪ n ɪ
sykurlaus	s ɪː k ʏ r l œː j s
sykurræktin	s ɪː k ʏ r a j x t ɪ n
systralaginu	s ɪ s t r a l a j ɪ n ʏ
tagi	t aː j ɪ
taginu	t aː j ɪ n ʏ
taktlaust	tʰ a x t l œ j s t
tangó	t a ŋ k ou
tangur	t a ŋ k ʏ r
tanka	t a ŋ̊ k a
tanki	t a ɲ̊ c ɪ
tankinn	t a ɲ̊ c ɪ n
tankinum	t a ɲ̊ c ɪ n ʏ m
tanks	t a ŋ̊ k s
tankurinn	t a ŋ̊ k ʏ r ɪ n
tannlæknaskólann	tʰ a n l a j h k n a s k ɔː u l a n
tannlæknaskólann	tʰ a n l a j h k n a s k ɔː u l a n
tannstöngla	tʰ a n s t œ j ŋ l a
tannstönglana	tʰ a n s t œ j ŋ l a n a
taóisma	tʰ aː ɔ u ɪ s m a
taraldseyju	tʰ aː r a l t s ɛ j ʏ
taugaber	tʰ œː j ɣ a p ɛː r
taugadeild	tʰ œː j ɣ a t ɛ j l t
taugadeild	tʰ œː j ɣ a t ɛ j l t
taugakerfi	tʰ œː j ɣ a cʰ ɛ r v ɪ
taugasérfræðinginn	tʰ œː j ɣ a s j ɛ r̥ f r a j ð i ɲ c ɪ n
taugasérfræðinginn	tʰ œː j ɣ a s j ɛ r̥ f r a j ð i ɲ c ɪ n
taugungamótum	tʰ œː j ɣ u ŋ k a m ɔː u t ʏ m
taugungamótum	tʰ œː j ɣ u ŋ k a m ɔː u t ʏ m
taumleysi	tʰ œ j m l ɛ j s ɪ
taumleysi	tʰ œ j m l ɛ j s ɪ
taumurinn	tʰ œː j m ʏ r ɪ n
tei	t ɛː ɪ
teið	t ɛː ɪ ð
teighögg	tʰ ɛː j ɣ h œ k
teigmarka	tʰ ɛː j ɣ m a r̥ k a
teigmörk	tʰ ɛː j ɣ m œ r̥ k
teigsbjargi	tʰ ɛ j x s p j a r c ɪ
teiknimynda	tʰ ɛ j h k n ɪ m ɪ n t a
teiknimyndablöð	tʰ ɛ j h k n ɪ m ɪ n t a p l œː ð
teit	tʰ ɛː ɪ t
tekjulægri	tʰ ɛː c ʏ l a j ɣ r ɪ
tekjustreymi	tʰ ɛː c ʏ s t r ɛː j m ɪ
tengilið	tʰ ɛ j ɲ c ɪ l ɪ ð
tengiliðar	tʰ ɛ j ɲ c ɪ l ɪː ð a r
tengimerki	tʰ ɛ j ɲ c ɪ m ɛ r̥ c ɪ
tenginga	tʰ ɛ j ɲ c i ŋ k a
tengingalausnum	tʰ ɛ j ɲ c i ŋ k a l œ j s t n ʏ m
tengingalausnum	tʰ ɛ j ɲ c i ŋ k a l œ j s t n ʏ m
tengiskilmálum	tʰ ɛ j ɲ c ɪ s c ɪ l m au l ʏ m
tengiskrúfu	tʰ ɛ j ɲ c ɪ s k r uː v ʏ
tengjum	tʰ ɛ j ɲ c ʏ m
tengla	tʰ ɛ j ŋ l a
tengslafund	tʰ ɛ j ŋ s t l a f ʏ n t
tengsli	tʰ ɛ j ŋ s t l ɪ
tennisknattleik	tʰ ɛ n ɪ s kʰ n a h t l ɛ j k
termítahaugum	tʰ ɛ r m i t a h œː j ɣ ʏ m
teskeið	tʰ ɛː s c ɛ j ð
textaleikfimi	tʰ ɛ k s t a l ɛː j k f ɪ m ɪ
textauppbyggingu	tʰ ɛ k s t a ʏ h p ɪ c i ŋ k ʏ
teygist	tʰ ɛ j ɪ s t
teygjast	tʰ ɛː j a s t
teyma	tʰ ɛː j m a
theodóra	tʰ ɛː ɔ t ɔː u r a
theodóru	tʰ ɛː ɔ t ɔː u r ʏ
thorsteinn	tʰ ɔ r̥ s t ɛ j t n̥
tilbeiðsluhúsin	tʰ ɪ l p ɛ j ð s t l ʏ h uː s ɪ n
tilfinningaleysi	tʰ ɪ l f ɪ n i ŋ k a l ɛː j s ɪ
tilfinningasnauð	tʰ ɪ l f ɪ n i ŋ k a s t n œ j ð
tilfæringar	tʰ ɪ l f a j r i ŋ k a r
tilgang	t ɪ l k a ŋ k
tilgangi	t ɪ l k a ɲ c ɪ
tilganginn	t ɪ l k a ɲ c ɪ n
tilgangslaus	t ɪ l k a ŋ k s t l œy s
tilgangslausa	t ɪ l k a ŋ k s t l œy s a
tilgangslaust	t ɪ l k a ŋ k s t l œy s t
tilgangsleysi	t ɪ l k a ŋ k s t l ei s ɪ
tilgangur	t ɪ l k a ŋ k ʏ r
tilgangurinn	t ɪ l k a ŋ k ʏ r ɪ n
tilgreinir	tʰ ɪ l k r ɛ j n ɪ r
tillöguteikningar	tʰ ɪ l œ ɣ ʏ tʰ ɛ j h k n i ŋ k a r
tilneyddan	tʰ ɪ l n ɛ j t a n
tilraunaglasi	tʰ ɪ l r œ j n a k l aː s ɪ
tilraunakennd	tʰ ɪ l r œ j n a cʰ ɛ n t
tilraunanna	tʰ ɪ l r œ j n a n a
tilraunarinnar	tʰ ɪ l r œ j n a r ɪ n a r
tilraunaskýrslur	tʰ ɪ l r œ j n a s c i s t l ʏ r
tilraunastarfsemina	tʰ ɪ l r œ j n a s t a r s ɛ m ɪ n a
tilraunaverkefna	tʰ ɪ l r œ j n a v ɛ r̥ k ɛ p n a
tilraununum	tʰ ɪ l r œ j n ɔ n ʏ m
tiltakagóður	tʰ ɪ l tʰ a k a k ɔː u ð ʏ r
tiltækur	tʰ ɪ l tʰ a j k ʏ r
tjáningarfullur	tʰ j aː u n i ŋ k a r f ʏ t l ʏ r
tjáningin	tʰ j aː u n i ɲ c ɪ n
tjáskiptahjálpartækjum	tʰ j aː u s c ɪ f t a ç au l̥ p a r̥ tʰ aː j c ʏ m
tjónabíll	tʰ j ɔː u n a p i t l̥
tjónaskuld	tʰ j ɔː u n a s k ʏ l t
tjöruhreinsi	tʰ j œː r ʏ r̥ ɛ j n s ɪ
togið	tʰ ɔ j ɪ ð
toginleitur	t ɔː j ɪ n l eiː t ʏ r
togveiðiskips	tʰ ɔ ɣ v ɛ j ð ɪ s c ɪ f s
tollstjóri	tʰ ɔ t l s t j ɔ u r ɪ
tollstjórn	tʰ ɔ t l s t j ɔ u r t n̥
tollumdæmi	tʰ ɔ t l ʏ m t a j m ɪ
torfbær	tʰ ɔ r p a j r
traustadóttur	tʰ r œ j s t a t ɔ u h t ʏ r
traustadóttur	tʰ r œ j s t a t ɔ u h t ʏ r
traustasyni	tʰ r œ j s t a s ɪː n ɪ
treyjum	tʰ r ɛ j ʏ m
trjásneiðunum	tʰ r j aː u s t n ɛ j ð ɔ n ʏ m
trjásneiðunum	tʰ r j aː u s t n ɛ j ð ɔ n ʏ m
trogið	t r ɔː j ɪ ð
trommuleikararnir	tʰ r ɔ m ʏ l ɛː j k a r a t n ɪ r
trommuleikarinn	tʰ r ɔ m ʏ l ɛː j k a r ɪ n
trúarhreyfinga	tʰ r uː a r̥ ɛː j v i ŋ k a
trúarofstæki	tʰ r uː a r ɔ f s t a j c ɪ
tryggvabraut	tʰ r ɪ k v a p r œː j t
tröllahópnum	tʰ r œ t l a h ɔ u h p n ʏ m
tugi	t ʏː j ɪ
tugir	t ʏː j ɪ r
tugmilljóna	tʰ ʏ ɣ m ɪ l j ɔ u n a
tungnaá	tʰ u ŋ n a aː u
tveim	t v ɛː m
tveimur	t v ɛː m ʏ r
tveimur	t v ɛː m ʏ r
tvígang	t v iː k a ŋ k
tvíhleypum	tʰ v i l̥ ɛ j p ʏ m
tvíhljóðunar	tʰ v i l̥ j ɔ u ð ʏ n a r
tvíliðaleikur	tʰ v iː l ɪ ð a l ɛː j k ʏ r
tvíæringurinn	tʰ v iː a j r i ŋ k ʏ r ɪ n
tyggjó	tʰ ɪ c ɔ u
ullarkápa	ʏ t l a r kʰ aː u p a
ullhærð	ʏ t l̥ h a j r ð
umbótastefnunnar	ʏ m p ɔ u t a s t ɛ p n ʏ n a r
umbótaverkefnum	ʏ m p ɔ u t a v ɛ r̥ k ɛ p n ʏ m
umbreytt	ʏ m p r ɛ j h t
umdæminu	ʏ m t a j m ɪ n ʏ
umfang	ʏ m f a ŋ k
umfangi	ʏ m f a ɲ c ɪ
umfangs	ʏ m f a ŋ s
umfangsmeiri	ʏ m f a ŋ s m eiː r ɪ
umfangsmesta	ʏ m f a ŋ s m ɛ s t a
umfangsmikið	ʏ m f a ŋ s m ɪː c ɪ ð
umfangsmikil	ʏ m f a ŋ s m ɪː c ɪ l
umfangsmikilli	ʏ m f a ŋ s m ɪː c ɪ t l ɪ
umfangsmikla	ʏ m f a ŋ s m ɪ h k l a
umfangsmiklar	ʏ m f a ŋ s m ɪ h k l a r
umfangsmiklu	ʏ m f a ŋ s m ɪ h k l ʏ
umfangsmiklum	ʏ m f a ŋ s m ɪ h k l ʏ m
umhverfisfræðslu	ʏ m kʰ v ɛ r v ɪ s f r a j ð s t l ʏ
umhverfisleyfa	ʏ m kʰ v ɛ r v ɪ s l ɛ j v a
umhverfisráðuneyti	ʏ m kʰ v ɛ r v ɪ s r aː u ð ʏ n ɛ j t ɪ
umhverfisráðuneyti	ʏ m kʰ v ɛ r v ɪ s r aː u ð ʏ n ɛ j t ɪ
umhverfistækni	ʏ m kʰ v ɛ r v ɪ s tʰ a j h k n ɪ
umhverfisvænna	ʏ m kʰ v ɛ r v ɪ s v a j t n a
umreiknuð	ʏ m r ɛ j h k n ʏ ð
umræðufund	ʏ m r a j ð ʏ f ʏ n t
umræðuhópur	ʏ m r a j ð ʏ h ɔː u p ʏ r
umræðuhópur	ʏ m r a j ð ʏ h ɔː u p ʏ r
umræðupunktum	ʏ m r a j ð ʏ pʰ u ŋ̊ t ʏ m
umræðusíða	ʏ m r a j ð ʏ s iː ð a
umræðuvef	ʏ m r a j ð ʏ v ɛː v
umræðuverkefnið	ʏ m r a j ð ʏ v ɛ r̥ k ɛ p n ɪ ð
umræðuvettvang	ʏ m r a j ð ʏ v ɛ h t v au ŋ k
umsjónaraðila	ʏ m s j ɔ u n a r aː ð ɪ l a
umslagi	ʏ m s t l a j ɪ
umslagið	ʏ m s t l a j ɪ ð
umsóknanna	ʏ m s ɔ u h k n a n a
umsóknareyðublöð	ʏ m s ɔ u h k n a r ɛː j ð ʏ p l œ ð
umsóknareyðublöð	ʏ m s ɔ u h k n a r ɛː j ð ʏ p l œ ð
umsóknargögnum	ʏ m s ɔ u h k n a r k œ k n ʏ m
umsóknarinnar	ʏ m s ɔ u h k n a r ɪ n a r
umtalsgóður	ʏ m tʰ a l s k ɔː u ð ʏ r
undangengið	ʏ n t a n c ɛ j ɲ c ɪ ð
undangengið	ʏ n t a n c ɛ j ɲ c ɪ ð
undangenginni	ʏ n t a n c ei ɲ c ɪ n ɪ
undangengna	ʏ n t a n c ei ŋ k n a
undangengnu	ʏ n t a n c ei ŋ k n ʏ
undangengnum	ʏ n t a n c ei ŋ k n ʏ m
undankeppni	ʏ n t a n c ɛ h p n ɪ
undankeppninni	ʏ n t a n c ɛ h p n ɪ n ɪ
undankomuleið	ʏ n t a n k ɔ m ʏ l eiː ð
undirbúningsdeild	ʏ n t ɪ r p uː n i ŋ s t ɛ j l t
undirlagi	ʏ n t ɪ r l aː j ɪ
ungdómsins	u ŋ t ɔ u m s ɪ n s
ungdæmi	u ŋ t a j m ɪ
ungliðahreyfinga	u ŋ k l ɪ ð a r̥ ɛː j v i ŋ k a
unglingabækur	u ŋ l i ŋ k a p aː j k ʏ r
unglingadeildin	u ŋ l i ŋ k a t ɛ j l t ɪ n
unglingalandsmóti	u ŋ l i ŋ k a l a n t s m ɔ u t ɪ
unglingamóti	u ŋ l i ŋ k a m ɔː u t ɪ
ungmennadeildinni	u ŋ k m ɛ n a t ɛ j l t ɪ n ɪ
ungmennahreyfing	u ŋ k m ɛ n a r̥ ɛː j v i ŋ k
ungmennahreyfingunni	u ŋ k m ɛ n a r̥ ɛː j v i ŋ k ʏ n ɪ
ungmennaráð	u ŋ k m ɛ n a r aː u ð
ungsveit	u ŋ k s v ɛ j t
unnarsdóttur	ʏ n a r s t ɔ u h t ʏ r
unnsteinn	ʏ n s t ɛ j t n̥
unnsteinsdóttir	ʏ n s t ɛ j n s t ɔ u h t ɪ r
unnsteinsdóttir	ʏ n s t ɛ j n s t ɔ u h t ɪ r
uppdrættir	ʏ h p t r a j h t ɪ r
uppeldisfræðina	ʏ h p ɛ l t ɪ s f r aː j ð ɪ n a
uppfærir	ʏ h p f a j r ɪ r
uppfærslur	ʏ h p f a j r̥ s t l ʏ r
upphafspóstur	ʏ h p h a v s pʰ ɔ u s t ʏ r
upphengingar	ʏ h p h ɛ j ɲ c i ŋ k a r
upphleyptir	ʏ h p l̥ ɛ j f t ɪ r
upphleyptum	ʏ h p l̥ ɛ j f t ʏ m
upplagi	ʏ h p l a j ɪ
upplagið	ʏ h p l a j ɪ ð
upplímingafólksins	ʏ h p l i m i ŋ k a f ɔ u l̥ k s ɪ n s
upplýsingabækling	ʏ h p l i s i ŋ k a p a j h k l i ŋ k
upplýsingartækni	ʏ h p l i s i ŋ k a r̥ tʰ a j h k n ɪ
upplýsingatækniiðnaðarins	ʏ h p l i s i ŋ k a tʰ a j h k n ɪ ɪ ð n a ð a r ɪ n s
upplýsingatæknisvið	ʏ h p l i s i ŋ k a tʰ a j h k n ɪ s v ɪː ð
upplýsingaveita	ʏ h p l i s i ŋ k a v ɛː j t a
uppmjótt	ʏ h p m j ɔ u h t
uppreisnamanna	ʏ h p r ɛ j s t n a m a n a
uppreisnarfullt	ʏ h p r ɛ j s t n a r̥ f ʏ l̥ t
uppsveita	ʏ h p s v ɛ j t a
urðarhólamýri	ʏ r ð a r h ɔ u l a m iː r ɪ
urðunarrein	ʏ r ð ʏ n a r ɛː j n
utankjörfundar	ʏː t a ŋ cʰ œ r̥ f ʏ n t a r
utanríkisráðherrarnir	ʏː t a n r i c ɪ s r aː u ð h ɛ r a t n ɪ r
úlfhéðinsdóttir	u l v ç ɛ ð ɪ n s t ɔ u h t ɪ r
úlfljóti	u l l j ɔ u t ɪ
úlfljótur	u l l j ɔ u t ʏ r
úlpukaupanna	u l̥ p ʏ kʰ œː j p a n a
úrgang	u r k a ŋ k
úrgangi	u r k a ɲ c ɪ
úrgangs	u r k a ŋ s
úrgangur	u r k a ŋ k ʏ r
úrskeiðis	u r̥ s c ɛ ð ɪ s
úrtakshópnum	u r̥ tʰ a k s h ɔ u h p n ʏ m
úrtökumótsins	u r̥ tʰ œ k ʏ m ɔː u t s ɪ n s
útblæstrinum	uː t p l a j s t r ɪ n ʏ m
útbreiddu	uː t p r ɛ j t ʏ
útbreiðsluna	uː t p r ɛ j ð s t l ʏ n a
útey	uː t ɛ j
útfjólublá	uː t f j ɔ u l ʏ p l aː u
útfjólublá	uː t f j ɔ u l ʏ p l aː u
útflutningsaukning	uː t f l ʏ h t n i ŋ s œ j h k n i ŋ k
útgáfuheiti	uː t k au v ʏ h ɛː j t ɪ
útgerðarstjóra	uː t c ɛ r ð a r̥ s t j ɔː u r a
útgöngubanni	uː t k œ j ŋ k ʏ p a n ɪ
útgönguopið	uː t k œ j ŋ k ʏ ɔː p ɪ ð
úthafskarfaveiðar	uː t a f s kʰ a r v a v ɛː j ð a r
úthlutunarfjárhæð	uː t l̥ ʏ t ʏ n a r f j aː u r h a j ð
úthlutunarfjárhæð	uː t l̥ ʏ t ʏ n a r f j aː u r h a j ð
úthlutunarkvóta	uː t l̥ ʏ t ʏ n a r̥ kʰ v ɔː u t a
úthreinsun	uː t r̥ ɛ j n s ʏ n
útigaur	uː t ɪ k œ j r
útilegubátum	uː t ɪ l ɛ ɣ ʏ p aː u t ʏ m
útiskreytingar	uː t ɪ s k r ɛː j t i ŋ k a r
útivistareyjan	uː t ɪ v ɪ s t a r ɛː j a n
útlagi	uː t l a j ɪ
útreikningunum	uː t r ɛ j h k n i ŋ k ɔ n ʏ m
útsaumaðir	uː t s œ j m a ð ɪ r
útsaumi	uː t s œ j m ɪ
útsaumsgarn	uː t s œ j m s k a r t n̥
útskilnaðarleið	uː t s c ɪ l n a ð a r l ɛː j ð
útslagið	uː t s t l a j ɪ ð
útsmoginn	uː t s m ɔ j ɪ n
úttaugar	uː t œ j ɣ a r
útvarpsgeislunin	uː t v a r̥ s c ɛ j s t l ʏ n ɪ n
útvarpshausar	uː t v a r̥ p s h œː j s a r
vagngeymsla	v a k n̥ k ɛ j m s t l a
valdahópnum	v a l t a h ɔ u h p n ʏ m
valdbeitingar	v a l t p ɛ j t i ŋ k a r
valgreinar	v a l k r ɛ j n a r
vallarstærð	v a t l a r̥ s t a j r ð
vallarsveifgrass	v a t l a r̥ s v ɛ j v k r aː s
valmöguleikarnir	v a l m œ ɣ ʏ l ɛː j k a t n ɪ r
valsdóttur	v a l s t ɔ u h t ʏ r
valsheimilinu	v a l s h ɛ j m ɪ l ɪ n ʏ
vanaheimi	v aː n a h ɛː j m ɪ
vandkvæða	v a n t kʰ v a j ð a
vandræðunum	v a n t r a j ð ɔ n ʏ m
vanga	v a ŋ k a
vangann	v a ŋ k a n
vanganum	v a ŋ k a n ʏ m
vangar	v a ŋ k a r
vangasvip	v a ŋ k a s v ɪː p
vangaveltum	v a ŋ k a v ɛ l̥ t ʏ m
vangaveltur	v a ŋ k a v ɛ l̥ t ʏ r
vangefinna	v a ɲ c ɛ v ɪ n
vangi	v a ɲ c ɪ
vanginn	v a ɲ c ɪ n
vangreidds	v a ŋ k r ɛ j t s
vangreidds	v a ŋ k r ɛ j t s
vanilluflaug	v aː n ɪ l ʏ f l œː j ɣ
vankaður	v a ŋ̊ k a ð ʏ r
vankúvereyju	v a ŋ k u v ɛ r ɛː j ʏ
vankúvereyju	v a ŋ k u v ɛ r ɛː j ʏ
varaskeifa	v aː r a s c ɛː j v a
varaskjár	v aː r a s c aː u r
varmaframleiðsla	v a r m a f r a m l ɛ j ð s t l a
varmaframleiðslueiningum	v a r m a f r a m l ɛ j ð s t l ʏ ɛː j n i ŋ k ʏ m
varmafræðilegan	v a r m a f r a j ð ɪ l ɛː ɣ a n
varmageislun	v a r m a c ɛ j s t l ʏ n
varmaleiðni	v a r m a l ɛ j ð n ɪ
varnarlausra	v a r t n a r l œː j s r a
varnarnúllteina	v a r t n a r n u l tʰ ɛ j n a
vasadiskó	v aː s a t ɪ s k ɔ u
vatnablá	v a h t n a p l aː u
vatnagrasasósu	v a h t n a k r a s a s ɔː u s ʏ
vatnleysuströnd	v a h t n̥ l ɛ j s ʏ s t r œ n t
vatnsflóð	v a s f l ɔ u ð
vatnshrædd	v a s r̥ a j t
vatnsleiðslur	v a s l ɛ j ð s t l ʏ r
vatnsleikfimi	v a s l ɛ j k f ɪ m ɪ
vatnsleysni	v a s l ɛ j s t n ɪ
vatnsleysnin	v a s l ɛ j s t n ɪ n
vatnsmelóna	v a s m ɛ l ɔ u n a
vatnsnæli	v a s t n a j l ɪ
vatnstjóns	v a s tʰ j ɔ u n s
vaxtabótakerfisins	v a k s t a p ɔ u t a cʰ ɛ r v ɪ s ɪ n s
vaxtareikningur	v a k s t a r̥ ɛ j h k n i ŋ k ʏ r
vaxtarlagið	v a k s t a r l a j ɪ ð
veðurtengdra	v ɛː ð ʏ r tʰ ɛ j ŋ t r a
vefbókasafn	v ɛ v p ɔ u k a s a p n̥
vefdagbækur	v ɛ v t a ɣ p a j k ʏ r
veffyrirtækinu	v ɛ f ɪ r ɪ r tʰ aː j c ɪ n ʏ
vefjagigt	v ɛ v j a c ɪ x t
vefjagigtar	v ɛ v j a c ɪ x t a r
vefjagigtarhópar	v ɛ v j a r c ɪ x t a r h ouː p a r
vefjagigtarhópur	v ɛ v j a r c ɪ x t a r h ouː p ʏ r
vefjagreiningar	v ɛ v j a k r ɛː j n i ŋ k a r
vefjaræktunin	v ɛ v j a r a j x t ʏ n ɪ n
veflausn	v ɛ v l œ j s t n̥
vefleit	v ɛ v l ɛ j t
vefmæling	v ɛ v m a j l i ŋ k
vefpóstur	v ɛ v pʰ ɔ u s t ʏ r
vefslóð	v ɛ f s t l ɔ u ð
vefslóðir	v ɛ f s t l ɔ u ð ɪ r
vefstjórn	v ɛ f s t j ɔ u r t n̥
vefsvæðinu	v ɛ f s v a j ð ɪ n ʏ
vefumsóknum	v ɛː v ʏ m s ɔ u h k n ʏ m
vefveitu	v ɛ v ɛ j t ʏ
vefvæna	v ɛ v a j n a
vegaframkvæmdum	v ɛː ɣ a f r a m kʰ v a j m t ʏ m
veiddan	v ɛ j t a n
veifar	v ɛː j v a r
veififórn	v ɛː j v ɪ f ɔ u r t n̥
veififórn	v ɛː j v ɪ f ɔ u r t n̥
veigamiklar	v ɛː j ɣ a m ɪ h k l a r
veikindaréttar	v ɛː j c ɪ n t a r j ɛ h t a r
veikindastúss	v ɛː j c ɪ n t a s t u s
veinin	v ɛː j n ɪ n
veirurnar	v ɛː j r ʏ t n a r
veirusýkingarlyfin	v ɛː j r ʏ s i c i ŋ k a r l ɪː v ɪ n
veirusýkingu	v ɛː j r ʏ s iː c i ŋ k ʏ
veiruvarnir	v ɛː j r ʏ v a r t n ɪ r
veisluborðunum	v ɛ j s t l ʏ p ɔ r ð ɔ n ʏ m
veislugír	v ɛ j s t l ʏ k iː r
veitingarstaðnum	v ɛː j t i ŋ k a r̥ s t a ð n ʏ m
veitingaskólans	v ɛː j t i ŋ k a s k ɔː u l a n s
veitingaskólans	v ɛː j t i ŋ k a s k ɔː u l a n s
veitugöng	v ɛː j t ʏ k œ j ŋ k
veitugöng	v ɛː j t ʏ k œ j ŋ k
velferðarstjórn	v ɛ l f ɛ r ð a r s t j ɔ u r t n̥
velsæmismörk	v ɛ l s a j m ɪ s m œ r̥ k
verkefnastjórnar	v ɛ r̥ k ɛ p n a s t j ɔ u r t n a r
verkfallsstjórnar	v ɛ r̥ k f a l s t j ɔ u r t n a r
verkframkvæmdir	v ɛ r̥ k f r a m kʰ v a j m t ɪ r
verkfræðideildinni	v ɛ r̥ k f r a j ð ɪ t ɛ j l t ɪ n ɪ
verkfræðideildinni	v ɛ r̥ k f r a j ð ɪ t ɛ j l t ɪ n ɪ
verkfræðimenntun	v ɛ r̥ k f r a j ð ɪ m ɛ n̥ t ʏ n
verkfræðistofan	v ɛ r̥ k f r a j ð ɪ s t ɔː v a n
verkfræðistofuna	v ɛ r̥ k f r a j ð ɪ s t ɔː v ʏ n a
verkfræðistofunni	v ɛ r̥ k f r a j ð ɪ s t ɔː v ʏ n ɪ
verklagi	v ɛ r̥ k l a j ɪ
verslanaflóru	v ɛ r̥ s t l a n a f l ɔː u r ʏ
verslunargreina	v ɛ r̥ s t l ʏ n a r̥ k r ɛː j n a
verslunarprófsins	v ɛ r̥ s t l ʏ n a r̥ pʰ r ɔ u f s ɪ n s
verslunartækni	v ɛ r̥ s t l ʏ n a r̥ tʰ a j h k n ɪ
veruleikar	v ɛː r ʏ l ɛː j k a r
veruleikatengdir	v ɛː r ʏ l ɛ j k a tʰ ɛ j ŋ t ɪ r
vestfjarðaprófastsdæmi	v ɛ s t f j a r ð a pʰ r ɔː u f a s t a j m ɪ
vestfjarðaprófastsdæmi	v ɛ s t f j a r ð a pʰ r ɔː u f a s t a j m ɪ
vesturhópi	v ɛ s t ʏ r h ɔː u p ɪ
vetrarbeitar	v ɛː t r a r̥ p ɛː j t a r
vetrarbrautinni	v ɛː t r a r̥ p r œː j t ɪ n ɪ
vetrarfóðruð	v ɛː t r a r̥ f ɔ u ð r ʏ ð
vetrarheimkynni	v ɛː t r a r̥ h ɛ j m cʰ ɪ n ɪ
vetrarlagi	v ɛː t r a r l aː j ɪ
vetrarmóti	v ɛː t r a r m ɔː u t ɪ
viðarteinungur	v ɪː ð a r̥ tʰ ɛː j n u ŋ k ʏ r
viðaukum	v ɪː ð œ j k ʏ m
viðeyjardæmi	v ɪː ð ɛ j a r t aː j m ɪ
viðeyjardæmi	v ɪː ð ɛ j a r t aː j m ɪ
viðhaldsdeild	v ɪː ð h a l t s t ɛ j l t
viðkvæmri	v ɪ ð kʰ v a j m r ɪ
viðmiðunarhópur	v ɪ ð m ɪ ð ʏ n a r̥ h ɔː u p ʏ r
viðræðufundur	v ɪ ð r a j ð ʏ f ʏ n t ʏ r
viðskiptabönkum	v ɪ ð s c ɪ f t a p œ j ŋ̊ k ʏ m
viðskiptafræðinema	v ɪ ð s c ɪ f t a f r a j ð ɪ n ɛː m a
viðskiptafræðinemar	v ɪ ð s c ɪ f t a f r a j ð ɪ n ɛː m a r
viðskiptaspænska	v ɪ ð s c ɪ f t a s p a j n s k a
viðskiptatengsla	v ɪ ð s c ɪ f t a tʰ ɛ j ŋ s t l a
viðskiptaumhverfi	v ɪ ð s c ɪ f t a ʏ m k v ɛ r v ɪ
viðskiptaumhverfi	v ɪ ð s c ɪ f t a ʏ m x v ɛ r v ɪ
viðureignina	v ɪː ð ʏ r ɛ j k n ɪ n a
vigtarnótu	v ɪ x t a r n ɔː u t ʏ
vigtarskírteini	v ɪ x t a r̥ s c i r̥ t ɛ j n ɪ
vikukaup	v ɪː k ʏ kʰ œː j p
vikurbreyskju	v ɪː k ʏ r p r ɛ j s c ʏ
viljalaus	v ɪ l j a l œː j s
viljugir	v ɪ l j ʏ j ɪ r
villbráð	v ɪ t l ɪ p r aː u ð
vinabæjarins	v ɪː n a p a j a r ɪ n s
vindskeiðin	v ɪ n t s c ɛ j ð ɪ n
vinmæli	v ɪ n m a j l ɪ
vinnsluhæfa	v ɪ n s t l ʏ h aː j v a
vinnslustjóra	v ɪ n s t l ʏ s t j ɔː u r a
vinnubækur	v ɪ n ʏ p aː j k ʏ r
vinnuhópa	v ɪ n ʏ h ɔː u p a
vinnuhópnum	v ɪ n ʏ h ɔ u h p n ʏ m
vinnuhópsins	v ɪ n ʏ h ɔ u p s ɪ n s
vinnuhópurinn	v ɪ n ʏ h ɔː u p ʏ r ɪ n
vinnuskólans	v ɪ n ʏ s k ɔː u l a n s
vinnuskólanum	v ɪ n ʏ s k ɔː u l a n ʏ m
vinnustóll	v ɪ n ʏ s t ɔ u t l̥
vinstriróttækir	v ɪ n s t r ɪ r ɔ u t a j c ɪ r
vinstriróttækir	v ɪ n s t r ɪ r ɔ u t a j c ɪ r
virkjunarleyfis	v ɪ r̥ c ʏ n a r l ɛː j v ɪ s
vistfræðin	v ɪ s t f r a j ð ɪ n
vistheimilisins	v ɪ s t h ɛ j m ɪ l ɪ s ɪ n s
visthæfa	v ɪ s t h a j v a
vitabraut	v ɪː t a p r œː j t
vitavonlaust	v ɪː t a v ɔ n l œ j s t
vitleysingurinn	v ɪ h t l ɛ j s i ŋ k ʏ r ɪ n
vitnaleiðslum	v ɪ h t n a l ɛ j ð s t l ʏ m
vogi	v ɔː j ɪ
vogina	v ɔ j ɪ n a
voginn	v ɔː j ɪ n
voginum	v ɔː j ɪ n ʏ m
vogir	v ɔ j ɪ r
volvó	v ɔ l v ɔ u
vonarsmæð	v ɔː n a r s m a j ð
vonlausu	v ɔ n l œ j s ʏ
vorflóðin	v ɔ r̥ f l ɔ u ð ɪ n
vorhveiti	v ɔː r̥ kʰ v ɛ j t ɪ
vorlagi	v ɔː r l a j ɪ
vothey	v ɔː t h ɛ j
vöngum	v œ ŋ k ʏ m
vöngunum	v œ ŋ k ɔ n ʏ m
vönkuð	v œ ŋ̊ k ʏ ð
yfirbreiðslu	ɪː v ɪ r̥ p r ɛ j ð s t l ʏ
yfirdráttarheimild	ɪː v ɪ r̥ t r au h t a r h ɛː j m ɪ l t
yfirfangavörður	ɪː v ɪ r f a ŋ k a v œ r ð ʏ r
yfirflugi	ɪː v ɪ r̥ f l ʏ j ɪ
yfirfærsluheimild	ɪː v ɪ r̥ f a j r̥ s t l ʏ h ɛː j m ɪ l t
yfirfærsluheimild	ɪː v ɪ r̥ f a j r̥ s t l ʏ h ɛː j m ɪ l t
yfirgang	ɪː v ɪ r k a ŋ k
yfirgangi	ɪː v ɪ r k a ɲ c ɪ
yfirgengilega	ɪː v ɪ r k ɛ ŋ c ɪ l ɛ ɣ a
þakklæðningar	θ aː k l a j ð n i ŋ k a r
þangað	θ a ŋ k a ð
þangi	θ a ɲ c ɪ
þangið	θ a ɲ c ɪ ð
þarfagreinir	θ a r v a k r ɛː j n ɪ r
þarmabólgu	θ a r m a p ɔ u l k ʏ
þaulvanir	θ œ j l v aː n ɪ r
þáttastjórnandinn	θ au h t a s t j ɔ u r t n a n t ɪ n
þemahópunum	θ ɛː m a h ɔː u p ɔ n ʏ m
þeytast	θ ɛː j t a s t
þeytibakur	θ ɛː j t ɪ p a k ʏ r
þéttgreindur	θ j ɛ h t k r ɛ j n t ʏ r
þéttleiki	θ j ɛ h t l ɛ j c ɪ
þingey	θ i ŋ k ɛ j
þingeyrarhreppi	θ i ŋ k ɛ j r a r̥ ɛ h p ɪ
þingeyskt	θ i ŋ k ɛ j s t
þingvallastræti	θ i ŋ k v a t l a s t r aː j t ɪ
þjóðhátíðardaginn	θ j ouː ð h au t i ð a r t aː j ɪ n
þorgautur	θ ɔ r k œ j t ʏ r
þorgilsdóttur	θ ɔ r c ɪ l s t ɔ u h t ʏ r
Þorleifsdóttir	θ ɔ r l ei f s ɔː n
þorleiks	θ ɔ r l ɛ j k s
þorleikur	θ ɔ r l ɛ j k ʏ r
þorskaætt	θ ɔ r̥ s k a a j h t
þorsteina	θ ɔ r̥ s t ɛ j n a
þóleítbasalti	θ ɔː u l ɛ i t p aː s a l̥ t ɪ
þórarinsstaðir	θ ɔː u r a r ɪ n s t aː ð ɪ r
þórfríðar	θ ɔ u r̥ f r i ð a r
þórisvatn	θ ɔː u r ɪ s v a h t n̥
þórisvatni	θ ɔː u r ɪ s v a h t n ɪ
þóroddsdóttir	θ ɔː u r ɔ t s t ɔ u h t ɪ r
þóroddssonar	θ ɔː u r ɔ t s ɔː n a r
þórshafnarbúar	θ ɔ u r̥ s h a p n a r̥ p uː a r
þórsleiknum	θ ɔ u r̥ s t l ɛ j h k n ʏ m
þórsleiknum	θ ɔ u r̥ s t l ɛ j h k n ʏ m
þórsteinu	θ ɔ u r̥ s t ɛ j n ʏ
þórsteinu	θ ɔ u r̥ s t ɛ j n ʏ
þórveigu	θ ɔ u r v ɛ j ɣ ʏ
þórveigu	θ ɔ u r v ɛ j ɣ ʏ
þóttuna	θ ɔ u h t ʏ n a
þrautaleikur	θ r œː j t a l ɛː j k ʏ r
þrautaleikur	θ r œː j t a l ɛː j k ʏ r
þrautargönguna	θ r œː j t a r̥ k œ j ŋ k ʏ n a
þráhyggjurugl	θ r aː u h ɪ c ʏ r ʏ k l̥
þráins	θ r aː u ɪ n s
þrekrauna	θ r ɛː k r œ j n a
þrengisnámi	θ r ɛ j ɲ c ɪ s n aː u m ɪ
þrengisnámi	θ r ɛ j ɲ c ɪ s n aː u m ɪ
þrengra	θ r ɛ j ŋ k r a
þrepalaust	θ r ɛː p a l œ j s t
þriðjudaginn	θ r ɪ ð j ʏ t aː j ɪ n
þríeykið	θ r iː ɛ j c ɪ ð
þróttmikilli	θ r ɔ u h t m ɪ c ɪ t l ɪ
þróunaraðstoðarnefnd	θ r ɔː u ʏ n a r a ð s t ɔ ð a r n ɛ m t
þróunarbanka	θ r ɔː u ʏ n a r̥ p au ŋ̊ k a
þróunarforystu	θ r ɔː u ʏ n a r̥ f ɔː r ʏ s t ʏ
þróunarfræðilega	θ r ɔː u ʏ n a r̥ f r a j ð ɪ l ɛ ɣ a
þróunarfræðilega	θ r ɔː u ʏ n a r̥ f r a j ð ɪ l ɛ ɣ a
þróunarríkjum	θ r ɔː u ʏ n a r iː c ʏ m
þróunarsamvinna	θ r ɔː u ʏ n a r̥ s a m v ɪ n a
þróunarsamvinnu	θ r ɔː u ʏ n a r̥ s a m v ɪ n ʏ
þróunarsamvinnustofnun	θ r ɔː u ʏ n a r̥ s a m v ɪ n ʏ s t ɔ p n ʏ n
þróunarsjóður	θ r ɔː u ʏ n a r̥ s j ɔː u ð ʏ r
þróunarsviðsstjóri	θ r ɔː u ʏ n a r̥ s v ɪ ð s t j ɔ u r ɪ
þróunarverkefninu	θ r ɔː u ʏ n a r v ɛ r̥ k ɛ p n ɪ n ʏ
þrumufleyg	θ r ʏː m ʏ f l ɛː j ɣ
þrælahaldsins	θ r aː j l a h a l t s ɪ n s
þrælmagnað	θ r a j l m a k n a ð
þræsingi	θ r aː j s i ɲ c ɪ
þröngsýnir	θ r œ j ŋ k s i n ɪ r
þungbærara	θ u ŋ k p a j r a r a
þurrheys	θ ʏ r h ɛ j s
þurrlendissvæðinu	θ ʏ r l ɛ n t ɪ s v aː j ð ɪ n ʏ
þykktarmælinga	θ ɪ x t a r m aː j l i ŋ k a
þyngdaraukningu	θ i ŋ t a r œ j h k n i ŋ k ʏ
þyngdaráhrif	θ i ŋ t a r aː u r̥ ɪ v
þyngdarbreytinga	θ i ŋ t a r p r ɛː j t i ŋ k a
þyngdarlaust	θ i ŋ t a r l œ j s t
þýðingarhópunum	θ iː ð i ŋ k a r h ɔː u p ɔ n ʏ m
ædols	aː j t ɔ l s
æfingabókinni	aː j v i ŋ k a p ɔː u c ɪ n ɪ
æfingabókinni	aː j v i ŋ k a p ɔː u c ɪ n ɪ
æfingagöllum	aː j v i ŋ k a k œ l ʏ m
æfingakerfi	aː j v i ŋ k a cʰ ɛ r v ɪ
æfingaleikjum	aː j v i ŋ k a l ɛ j c ʏ m
æfingaleikjum	aː j v i ŋ k a l ɛ j c ʏ m
æfingamaður	aː j v i ŋ k a m aː ð ʏ r
æfingaprógramm	aː j v i ŋ k a pʰ r ɔ u r a m m
æfingaprógramm	aː j v i ŋ k a pʰ r ɔ u r a m m
æfingarkerfi	aː j v i ŋ k a r cʰ ɛ r v ɪ
æfingarleikir	aː j v i ŋ k a r l ɛː j c ɪ r
æfingarleikir	aː j v i ŋ k a r l ɛː j c ɪ r
æfingarleikur	aː j v i ŋ k a r l ɛː j k ʏ r
æfingarleikur	aː j v i ŋ k a r l ɛː j k ʏ r
æfingarsalnum	aː j v i ŋ k a r s a l n ʏ m
ægisbúar	aː j ɪ s p uː a r
ælukallinn	aː j l ʏ kʰ a t l ɪ n
æpandi	aː j p a n t ɪ
æpod	aː j p ɔ t
ærslafullir	a j r̥ s t l a f ʏ t l ɪ r
æsifréttamenn	aː j s ɪ f r j ɛ h t a m ɛ n
æsirnir	aː j s ɪ t n ɪ r
æskja	a j s c a
æskulandið	a j s k ʏ l a n t ɪ ð
æskulýðssamband	a j s k ʏ l i ð s a m p a n t
ætihvönn	aː j t ɪ kʰ v œ n
ættarsaga	a j h t a r s aː ɣ a
ættartölum	a j h t a r̥ tʰ œː l ʏ m
ættartölurnar	a j h t a r̥ tʰ œː l ʏ t n a r
ættbálkar	a j h t p au l̥ k a r
ættbálki	a j h t p au l̥ c ɪ
ættbókarfærð	a j h t p ɔ u k a r f a j r ð
ættbókarfærð	a j h t p ɔ u k a r f a j r ð
ættbókin	a j h t p ɔ u c ɪ n
ættbókin	a j h t p ɔ u c ɪ n
ættbækur	a j h t p a j k ʏ r
ættgöfugra	a j h t k œ v ʏ ɣ r a
ættkvísl	a j h t kʰ v i s t l̥
ættkvíslarinnar	a j h t kʰ v i s t l a r ɪ n a r
ættkvíslina	a j h t kʰ v i s t l ɪ n a
ættleiðingarferlinu	a j h t l ɛ j ð i ŋ k a r f ɛ r t l ɪ n ʏ
ættleiðingarferlinu	a j h t l ɛ j ð i ŋ k a r f ɛ r t l ɪ n ʏ
ættliðaskiptin	a j h t l ɪ ð a s c ɪ f t ɪ n
ættmeið	a j h t m ɛ j ð
ættmeið	a j h t m ɛ j ð
ættstór	a j h t s t ɔː u r
ættstór	a j h t s t ɔː u r
ætur	aː j t ʏ r
ævilanga	aiː v ɪ l a ŋ k a
ævilangt	aiː v ɪ l a ŋ̊ t
ævintýraleikir	aː j v ɪ n tʰ i r a l ɛː j c ɪ r
ævintýraleikir	aː j v ɪ n tʰ i r a l ɛː j c ɪ r
ævintýrasiglingu	aː j v ɪ n tʰ i r a s ɪ k l i ŋ k ʏ
æxlis	a j k s t l ɪ s
æxlissega	a j k s t l ɪ s ɛː ɣ a
æxlisvöxt	a j k s t l ɪ s v œ k s t
æxlunar	a j k s t l ʏ n a r
öfughneigð	œː v ʏ ɣ n̥ ɛ j ɣ ð
ökutækjaflokkum	œː k ʏ tʰ a j c a f l ɔ h k ʏ m
ölteiti	œ l tʰ ɛ j t ɪ
öndunaræfingarnar	œ n t ʏ n a r aː j f i ŋ k a t n a r
öngulrassar	œ j ŋ k ʏ l r a s a r
örlygsdóttur	œ r l ɪ k s t ɔ u h t ʏ r
örlögleysi	œ r l œ ɣ l ɛː j s ɪ
örnefnaskrá	œ r n ɛ p n a s k r aː u
öryggisleysis	œː r ɪ c ɪ s l ɛː j s ɪ s
öryggissveita	œː r ɪ c ɪ s v ɛː j t a
öryrkjabandalagi	œː r ɪ r̥ c a p a n t a l a j ɪ
öryrkjabandalaginu	œː r ɪ r̥ c a p a n t a l a j ɪ n ʏ
össurardóttur	œ s ʏ r a r t ɔ u h t ʏ r
öxarhólma	œ k s a r h ɔ u l m a
==============CORRECT=============== 27025
